/film/film/featured_film_locations	featured film locations
/sports/sport/related_equipment	related equipment
/user/szaijan/fantasy_football/player/nfl_team	nfl team
/protected_sites/listed_site/designation_as_natural_or_cultural_site./protected_sites/natural_or_cultural_site_listing/designation	designation
/tv/tv_program/episodes	episodes
/protected_sites/listed_site/designation_as_natural_or_cultural_site./protected_sites/natural_or_cultural_site_listing/category_or_criteria	category or criteria
/education/educational_institution_campus/educational_institution	educational institution
/user/ktrueman/default_domain/international_organization/member_states	member states
/tv/tv_program/program_creator	program creator
/government/government_office_or_title/governmental_body_if_any	governmental body if any
/fictional_universe/fictional_character/powers_or_abilities	powers or abilities
/sports/sports_team_owner/teams_owned	teams owned
/people/ethnicity/included_in_group	included in group
/aviation/airline/hubs	hubs
/base/events/type_of_festival/recurring_festivals_of_this_type	recurring festivals of this type
/user/coco/science/concepts_theories/child_concept	child concept
/music/artist/supporting_artists	supporting artists
/government/legislative_session/legislature	legislature
/music/artist/origin	origin
/ice_hockey/hockey_player/hockey_position	hockey position
/fictional_universe/ethnicity_in_fiction/characters_of_this_ethnicity	characters of this ethnicity
/book/periodical_subject/periodicals	periodicals
/people/person/nationality	nationality
/tv/tv_subject/tv_programs	tv programs
/user/mt/default_domain/metabolite/biofluid_location	biofluid location
/user/tsegaran/random/taxonomy_subject/entry./user/tsegaran/random/taxonomy_entry/taxonomy	taxonomy
/religion/religious_organization/associated_with	associated with
/award/award_category/category_of	category of
/award/competition/instance_of_recurring_competition	instance of recurring competition
/film/film/produced_by	produced by
/base/schemastaging/organization_extra/phone_number./base/schemastaging/phone_sandbox/contact_category	contact category
/computer/operating_system/parent_os	parent os
/olympics/olympic_participating_country/olympics_participated_in	olympics participated in
/broadcast/content/broadcast	broadcast
/religion/religion/deities	deities
/time/time_zone/locations_in_this_time_zone	locations in this time zone
/comic_books/comic_book_creator/characters_created	characters created
/base/ecology/food_web_member/belongs_to_ecosystem_s	belongs to ecosystem s
/user/alexbl/honorary_title/honorary_title/titled_people./user/alexbl/honorary_title/honorary_title_holding/conferred_upon	conferred upon
/award/award_discipline/awards_in_this_discipline	awards in this discipline
/soccer/football_team/manager./soccer/football_team_management_tenure/manager	manager
/time/event/includes_event	includes event
/religion/religion/practices	practices
/education/school/highest_grade_taught	highest grade taught
/fictional_universe/fictional_character/species	species
/geography/island/island_group	island group
/business/sponsored_recipient/sponsorship./business/sponsorship/sponsored_by	sponsored by
/computer/software_developer/software	software
/film/film/film_set_decoration_by	film set decoration by
/tv/tv_program/spun_off_from	spun off from
/user/alexander/philosophy/philosopher/era	era
/base/newsevents/news_reported_event/news_report_s./base/newsevents/news_report/news_reporting_organisation	news reporting organisation
/location/location/people_born_here	people born here
/tv/tv_program/spin_offs	spin offs
/religion/religion/texts	texts
/computer/programming_language/language_designers	language designers
/music/artist/album	album
/media_common/netflix_title/netflix_genres	netflix genres
/base/popstra/company/fashion_choice./base/popstra/fashion_choice/fashion_wearer	fashion wearer
/time/recurring_event/instances	instances
/fictional_universe/fictional_character/married_to./fictional_universe/marriage_of_fictional_characters/spouses	spouses
/periodicals/newspaper_circulation_area/newspapers	newspapers
/fictional_universe/fictional_character/appears_in_these_fictional_universes	appears in these fictional universes
/music/genre/subgenre	subgenre
/base/thoroughbredracing/thoroughbred_racehorse_sex/horses_of_this_sex	horses of this sex
/organization/organization_type/organizations_of_this_type	organizations of this type
/computer/software_genre/software_in_genre	software in genre
/geography/island/body_of_water	body of water
/film/film/film_series	film series
/location/location/adjoin_s./location/adjoining_relationship/adjoins	adjoins
/architecture/architectural_style/examples	examples
/tv/tv_location/tv_shows_filmed_here	tv shows filmed here
/astronomy/orbital_relationship/orbits	orbits
/sports/professional_sports_team/owner_s	owner s
/military/military_conflict/military_personnel_involved	military personnel involved
/architecture/architect/structures_designed	structures designed
/book/author/works_written	works written
/film/film_production_designer/films_production_designed	films production designed
/food/diet/followers	followers
/fictional_universe/fictional_character_creator/fictional_characters_created	fictional characters created
/base/fight/crime_type/included_in_crimes	included in crimes
/organization/organization/parent./organization/organization_relationship/parent	parent
/base/argumentmaps/morally_disputed_activity/instance_of_abstract_moral_dispute	instance of abstract moral dispute
/base/rugby/rugby_player/type_of_rugby	type of rugby
/royalty/monarch/kingdom	kingdom
/geography/lake/lake_type	lake type
/base/aareas/schema/administrative_area/administrative_children	administrative children
/food/ingredient/incompatible_with_dietary_restrictions	incompatible with dietary restrictions
/award/award/presented_by	presented by
/music/group_member/vocal_range	vocal range
/government/governmental_jurisdiction/government_positions	government positions
/education/school_district/locations_served	locations served
/film/film_story_contributor/film_story_credits	film story credits
/sports/sport/officials	officials
/base/patronage/patron/related_client./base/patronage/patron_client_relationship/client	client
/location/location/partially_containedby	partially containedby
/sports/sports_championship_event/runner_up	runner up
/medicine/notable_person_with_medical_condition/condition	condition
/medicine/disease/treatments	treatments
/award/hall_of_fame_discipline/halls_of_fame	halls of fame
/medicine/symptom/symptom_of	symptom of
/film/film/film_festivals	film festivals
/base/popstra/celebrity/supporter./base/popstra/support/supported_organization	supported organization
/aviation/aircraft_model/number_owned_by./aviation/aircraft_ownership_count/aircraft_owner	aircraft owner
/book/written_work/author	author
/chemistry/chemical_compound/solubility./chemistry/solubility_relationship/solvent	solvent
/people/profession/people_with_this_profession	people with this profession
/book/author/school_or_movement	school or movement
/time/event/locations	locations
/medicine/symptom/side_effect_of	side effect of
/music/instrument/variation	variation
/organization/organization/child./organization/organization_relationship/child	child
/education/school_district/schools	schools
/transportation/road/major_cities	major cities
/martial_arts/martial_artist/martial_art	martial art
/fictional_universe/character_occupation/characters_with_this_occupation	characters with this occupation
/martial_arts/martial_art/well_known_practitioner	well known practitioner
/cvg/computer_videogame/cvg_genre	cvg genre
/aviation/airliner_accident/flight_destination	flight destination
/base/aareas/schema/administrative_area/administrative_parent	administrative parent
/medicine/disease/prevention_factors	prevention factors
/broadcast/producer/produces	produces
/royalty/noble_person/titles./royalty/noble_title_tenure/noble_title	noble title
/medicine/disease/notable_people_with_this_condition	notable people with this condition
/base/popstra/company/product_endorser./base/popstra/paid_support/endorser	endorser
/sports/sports_championship_event/championship	championship
/transportation/bridge_type/bridges_of_this_type	bridges of this type
/location/country/currency_used	currency used
/base/nobelprizes/nobel_subject_area/nobel_awards./base/nobelprizes/nobel_honor/nobel_prize_winner	nobel prize winner
/royalty/noble_title/noble_rank	noble rank
/soccer/football_player/goals_scored./soccer/football_goal/point_awarded_to	point awarded to
/education/educational_institution/sports_teams	sports teams
/organization/organization/sectors	sectors
/education/school/school_district	school district
/education/academic/research_areas	research areas
/book/magazine_genre/magazines_in_this_genre	magazines in this genre
/award/award_category/presenting_organization	presenting organization
/book/book_subject/works	works
/biology/organism/organism_type	organism type
/baseball/baseball_player/lifetime_batting_statistics./baseball/lifetime_batting_statistics/starting_season	starting season
/base/argumentmaps/innovator/original_ideas	original ideas
/base/fight/crime_type/victims_of_this_crime_type	victims of this crime type
/media_common/adaptation/adapted_from	adapted from
/film/film_costumer_designer/costume_design_for_film	costume design for film
/education/fraternity_sorority/colleges_and_universities	colleges and universities
/comic_books/comic_book_series/featured_characters	featured characters
/location/administrative_division/first_level_division_of	first level division of
/base/endorsements/endorsing_newspaper/endorsements./base/endorsements/newspaper_endorsement/election	election
/user/robert/us_congress/us_representative/congressional_caucus_memberships	congressional caucus memberships
/education/field_of_study/subdisciplines	subdisciplines
/fictional_universe/character_gender/characters_of_this_gender	characters of this gender
/base/x2010fifaworldcupsouthafrica/world_cup_participant/world_cup_team./base/x2010fifaworldcupsouthafrica/current_world_cup_squad/national_team	national team
/computer/computer/manufacturer	manufacturer
/broadcast/tv_station_owner/tv_stations	tv stations
/interests/collection_category/sub_categories	sub categories
/film/film/release_date_s./film/film_regional_release_date/film_regional_debut_venue	film regional debut venue
/education/field_of_study/subdiscipline_of	subdiscipline of
/organization/organization_scope/organizations_with_this_scope	organizations with this scope
/tv/tv_writer/episodes_written	episodes written
/base/ecology/ecosystem/ecosystem_members	ecosystem members
/base/saturdaynightlive/snl_cast_member/seasons./base/saturdaynightlive/snl_season_tenure/cast_members	cast members
/book/school_or_movement/associated_authors	associated authors
/computer/programming_language/language_paradigms	language paradigms
/business/sponsor/sponsorship./business/sponsorship/sponsored_recipient	sponsored recipient
/fictional_universe/person_in_fiction/representations_in_fiction	representations in fiction
/base/americancomedy/celebrity_impressionist/celebrities_impersonated	celebrities impersonated
/visual_art/artwork/art_form	art form
/cvg/computer_videogame/game_series	game series
/user/coco/science/concepts_theories/parent_concept	parent concept
/film/film/film_casting_director	film casting director
/tv/tv_actor/guest_roles./tv/tv_guest_role/episodes_appeared_in	episodes appeared in
/base/popstra/restaurant/restaurant_choice./base/popstra/restaurant_choice/diner	diner
/medicine/medical_specialty/diseases_treated	diseases treated
/music/group_member/instruments_played	instruments played
/cvg/cvg_publisher/games_published	games published
/government/governmental_body/offices_positions	offices positions
/royalty/royal_line/kingdom_s_ruled	kingdom s ruled
/baseball/baseball_player/lifetime_batting_statistics./baseball/lifetime_batting_statistics/ending_season	ending season
/base/locations/countries/continent	continent
/royalty/monarch/royal_line	royal line
/award/award_category/long_lists./award/long_list_nomination/nominee	nominee
/medicine/condition_prevention_factors/conditions_this_may_prevent	conditions this may prevent
/film/film_festival/individual_festivals	individual festivals
/education/educational_institution/school_type	school type
/base/bioventurist/bv_medical_condition/company_involved	company involved
/aviation/airline/focus_cities	focus cities
/film/film_festival_event/festival	festival
/user/tfmorris/default_domain/document/signatories	signatories
/book/author/series_written_or_contributed_to	series written or contributed to
/medicine/infectious_disease/infectious_agent_type	infectious agent type
/base/patronage/client/related_patron./base/patronage/patron_client_relationship/patron	patron
/medicine/drug/active_moieties	active moieties
/base/onephylogeny/type_of_thing/included_in	included in
/book/written_work/original_language	original language
/computer/programming_language_designer/languages_designed	languages designed
/base/thoroughbredracing/thoroughbred_racehorse_color/horses_of_this_color	horses of this color
/people/ethnicity/geographic_distribution	geographic distribution
/location/location/nearby_airports	nearby airports
/government/governmental_body/body_this_is_a_component_of	body this is a component of
/tv/tv_program_creator/programs_created	programs created
/sports/sports_championship_event/champion	champion
/venture_capital/venture_funded_company/venture_investors./venture_capital/venture_investment/investor	investor
/government/government_office_category/offices	offices
/organization/organization/legal_structure	legal structure
/medicine/disease/parent_disease	parent disease
/film/film/written_by	written by
/geography/body_of_water/islands	islands
/biology/organism_classification/higher_classification	higher classification
/location/country/first_level_divisions	first level divisions
/base/saints/saint/venerated_in	venerated in
/food/diet_follower/follows_diet	follows diet
/base/popstra/product/sold_to./base/popstra/product_choice/consumer	consumer
/computer/operating_system/includes_os_versions	includes os versions
/base/onephylogeny/type_of_thing/things_of_this_type	things of this type
/base/argumentmaps/abstract_moral_dispute/particular_instances	particular instances
/common/annotation_category/annotations	annotations
/biology/animal_breed/place_of_origin	place of origin
/base/americancomedy/comedian/comedy_genres	comedy genres
/base/eating/diets/people_who_follow_this_diet	people who follow this diet
/film/film/edited_by	edited by
/travel/travel_destination/climate./travel/travel_destination_monthly_climate/month	month
/royalty/kingdom/rulers	rulers
/music/instrument/instrumentalists	instrumentalists
/film/film/distributors./film/film_film_distributor_relationship/film_distribution_medium	film distribution medium
/religion/religious_practice/practice_of	practice of
/medicine/disease/symptoms	symptoms
/people/person/spouse_s./people/marriage/type_of_union	type of union
/medicine/drug_class/drugs	drugs
/broadcast/radio_station/format	format
/visual_art/art_subject/artwork_on_the_subject	artwork on the subject
/fictional_universe/work_of_fiction/part_of_these_fictional_universes	part of these fictional universes
/computer/software/license	license
/film/film_genre/films_in_this_genre	films in this genre
/broadcast/radio_format/stations	stations
/biology/animal_breed/registered_with./biology/breed_registration/registry	registry
/language/human_language/language_family	language family
/film/film/music	music
/travel/tourist_attraction/near_travel_destination	near travel destination
/base/schemastaging/organization_extra/phone_number./base/schemastaging/phone_sandbox/product_or_service	product or service
/architecture/building/building_function	building function
/medicine/drug_ingredient/more_general_ingredient	more general ingredient
/people/deceased_person/place_of_burial	place of burial
/location/us_county/hud_county_place	hud county place
/medicine/disease/risk_factors	risk factors
/base/argumentmaps/original_idea/innovator	innovator
/base/academyawards/host_of_oscar_show/oscar_show_hosted	oscar show hosted
/fictional_universe/fictional_character/occupation	occupation
/base/folklore/mythical_creature/mythology	mythology
/theater/theatrical_lyricist/play_lyrics_written	play lyrics written
/music/voice/singers	singers
/base/fashionmodels/hair_color/fashion_models_with_this_hair_color	fashion models with this hair color
/organization/organization/spin_offs./organization/organization_spin_off/child_company	child company
/people/person/sibling_s./people/sibling_relationship/sibling	sibling
/government/form_of_government/countries	countries
/people/cause_of_death/includes_causes_of_death	includes causes of death
/people/place_of_interment/interred_here	interred here
/aviation/airline/airports_served./aviation/airline_airport_presence/airport	airport
/base/events/performer/performances./base/events/performance/performer	performer
/astronomy/star_system/planetary_system	planetary system
/comic_books/comic_book_character/regular_featured_appearances	regular featured appearances
/film/film/runtime./film/film_cut/type_of_film_cut	type of film cut
/finance/currency/countries_used	countries used
/fictional_universe/character_species/characters_of_this_species	characters of this species
/organization/organization_sector/organizations_in_this_sector	organizations in this sector
/film/film/release_date_s./film/film_regional_release_date/film_release_distribution_medium	film release distribution medium
/internet/website_category/sites	sites
/government/political_party/ideology	ideology
/base/wrestling/professional_wrestler/member_of_team	member of team
/people/cause_of_death/parent_cause_of_death	parent cause of death
/architecture/museum/type_of_museum	type of museum
/language/human_language/writing_system	writing system
/time/event/instance_of_recurring_event	instance of recurring event
/base/thoroughbredracing/thoroughbred_racehorse_origin/horses_from_this_location	horses from this location
/fictional_universe/character_rank/characters_of_this_rank	characters of this rank
/base/events/festival_series/type_of_festival	type of festival
/user/mt/default_domain/metabolite/associated_disorder	associated disorder
/biology/animal_breed/breed_of	breed of
/music/conducted_ensemble/conductors./music/conducting_tenure/conductor	conductor
/aviation/aircraft_model/aircraft_type	aircraft type
/biology/organism_classification/lower_classifications	lower classifications
/visual_art/art_period_movement/associated_artists	associated artists
/fictional_universe/fictional_character/romantically_involved_with./fictional_universe/romantic_involvement/partner	partner
/metropolitan_transit/transit_line/service_type	service type
/biology/domesticated_animal/breeds	breeds
/location/country/administrative_divisions	administrative divisions
/religion/religion/places_of_worship	places of worship
/film/film_series/films_in_series	films in series
/base/crime/crime_victim/crime_type	crime type
/base/fashionmodels/fashion_model/hair_color	hair color
/award/ranked_item/appears_in_ranked_lists./award/ranking/list	list
/award/award_presenting_organization/awards_presented	awards presented
/base/folklore/mythology/mythical_creatures	mythical creatures
/music/group_member/artists_supported	artists supported
/media_common/netflix_genre/titles	titles
/tv/tv_program/filming_locations	filming locations
/education/fraternity_sorority/founded_location	founded location
/military/military_post/used_by_armed_forces./military/military_post_use/armed_force	armed force
/visual_art/artwork/art_subject	art subject
/government/political_party/politicians_in_this_party./government/political_party_tenure/politician	politician
/medicine/medical_treatment/side_effects	side effects
/music/conductor/groups./music/conducting_tenure/ensemble	ensemble
/base/popstra/celebrity/hangout./base/popstra/hangout/business_location	business location
/law/invention/inventor	inventor
/business/company_type/companies_of_this_type	companies of this type
/government/governmental_body/component_bodies	component bodies
/government/politician/party./government/political_party_tenure/party	party
/user/lindenb/default_domain/scientist/known_for	known for
/organization/organization_founder/organizations_founded	organizations founded
/broadcast/radio_station_owner/radio_stations	radio stations
/food/food/nutrients./food/nutrition_fact/nutrient	nutrient
/base/popstra/celebrity/wears./base/popstra/fashion_choice/designer	designer
/symbols/name_source/namesakes	namesakes
/film/film_featured_song/performed_by	performed by
/user/radiusrs/default_domain/astrology/related_topics	related topics
/fictional_universe/fictional_character/character_created_by	character created by
/film/film/film_art_direction_by	film art direction by
/base/fight/crime_type/includes_crimes	includes crimes
/location/location/contains	contains
/base/collectives/collective_member/member_of./base/collectives/collective_membership/collective	collective
/location/country/currency_formerly_used	currency formerly used
/book/newspaper/circulation_areas	circulation areas
/food/dietary_restriction/compatible_ingredients	compatible ingredients
/base/crime/crime/victim_s	victim s
/base/popstra/location/vacationers./base/popstra/vacation_choice/vacationer	vacationer
/base/popstra/business_location/customer./base/popstra/hangout/customer	customer
/base/twinnedtowns/twinned_town/twinned_with./base/twinnedtowns/town_twinning/twinned_towns	twinned towns
/medicine/drug_ingredient/active_moiety_of_drug	active moiety of drug
/base/infrastructure/power_plant_type/power_station	power station
/travel/travel_destination/tourist_attractions	tourist attractions
/aviation/airport/airlines./aviation/airline_airport_presence/airline	airline
/business/asset_owner/assets_owned./business/asset_ownership/owned_asset	owned asset
/medicine/disease/medical_specialties	medical specialties
/religion/religious_organization/leaders./religion/religious_organization_leadership/leader	leader
/education/field_of_study/academics_in_this_field	academics in this field
/medicine/drug/legal_status	legal status
/business/industry/companies	companies
/base/popstra/organization/supporter./base/popstra/support/supporter	supporter
/religion/religion/is_part_of	is part of
/user/tsegaran/computer/algorithm_family/algorithm	algorithm
/language/human_language/main_country	main country
/location/location/partially_contains	partially contains
/baseball/baseball_player/lifetime_batting_statistics./baseball/lifetime_batting_statistics/last_statistics_season	last statistics season
/award/award_category/disciplines_or_subjects	disciplines or subjects
/law/inventor/inventions	inventions
/internet/website_owner/websites_owned_new./internet/website_ownership/website	website
/computer/operating_system_developer/operating_systems_developed	operating systems developed
/film/film_casting_director/films_casting_directed	films casting directed
/computer/software/languages_used	languages used
/tv/tv_network/areas_served	areas served
/base/petbreeds/city_with_dogs/top_breeds./base/petbreeds/dog_city_relationship/dog_breed	dog breed
/geography/geographical_feature_category/features	features
/dataworld/gardening_hint/split_to	split to
/fictional_universe/fictional_character/siblings./fictional_universe/sibling_relationship_of_fictional_characters/siblings	siblings
/royalty/chivalric_order_member/belongs_to_order./royalty/chivalric_order_membership/order	order
/tv/tv_writer/tv_programs./tv/tv_program_writer_relationship/tv_program	tv program
/common/topic/webpage./common/webpage/resource	resource
/base/crime/convicted_criminal/convictions./base/crime/criminal_conviction/sentence_type	sentence type
/law/court/judges./law/judicial_tenure/judge	judge
/business/business_operation/industry	industry
/biology/breed_origin/breeds_originating_here	breeds originating here
/people/profession/specializations	specializations
/location/location/containedby	containedby
/broadcast/distributor/distributes	distributes
/medicine/disease/causes	causes
/base/locations/continents/countries_within	countries within
/base/activism/activism_issue/activist_organizations	activist organizations
/geography/lake_type/lakes_of_this_type	lakes of this type
/location/country/official_language	official language
/visual_art/visual_artist/associated_periods_or_movements	associated periods or movements
/sports/sport_country/athletic_performances./sports/competitor_competition_relationship/competitors	competitors
/comic_books/comic_book_creator/series_created	series created
/government/political_ideology/political_parties	political parties
/medicine/icd_9_cm_classification/parent_classification	parent classification
/time/event/included_in_event	included in event
/metropolitan_transit/transit_service_type/transit_lines	transit lines
/location/statistical_region/gdp_real./measurement_unit/adjusted_money_value/adjustment_currency	adjustment currency
/film/film/production_companies	production companies
/aviation/airport/focus_city_for	focus city for
/book/newspaper_owner/newspapers_owned	newspapers owned
/people/deceased_person/place_of_death	place of death
/aviation/airport/serves	serves
/organization/organization/founders	founders
/location/hud_county_place/place	place
/film/film_location/featured_in_films	featured in films
/medicine/medical_treatment/used_to_treat	used to treat
/exhibitions/exhibition_sponsor/exhibitions_sponsored./exhibitions/exhibition_run/venue	venue
/people/profession/specialization_of	specialization of
/base/schemastaging/organization_extra/phone_number./base/schemastaging/phone_sandbox/service_language	service language
/base/endorsements/endorsing_newspaper/endorsements./base/endorsements/newspaper_endorsement/endorsee	endorsee
/film/film/cinematography	cinematography
/media_common/media_genre/child_genres	child genres
/sports/sports_equipment/sport_used_for	sport used for
/people/person/profession	profession
/common/topic/subject_of	subject of
/base/popstra/celebrity/bought./base/popstra/product_choice/product	product
/games/game_genre/boardgames	boardgames
/protected_sites/iucn_category/protected_areas	protected areas
/location/statistical_region/places_exported_to./location/imports_and_exports/exported_to	exported to
/cvg/computer_videogame/designers	designers
/education/educational_institution/campuses	campuses
/geography/river/mouth	mouth
/organization/organization/involved_in_merger./organization/organization_merger/became_organization	became organization
/award/hall_of_fame/discipline	discipline
/architecture/building_function/buildings	buildings
/government/election/office	office
/location/administrative_division/second_level_division_of	second level division of
/architecture/architectural_structure_owner/structures_owned./architecture/ownership/structure	structure
/medicine/disease/includes_diseases	includes diseases
/aviation/aircraft_manufacturer/aircraft_models_made	aircraft models made
/aviation/airport/hub_for	hub for
/location/location/time_zones	time zones
/base/yalebase/secret_society_member/belonged_to./base/yalebase/secret_society_membership/society	society
/base/americancomedy/comedy_genre/comedians_in_this_genre	comedians in this genre
/sports/sports_team/arena_stadium	arena stadium
/cvg/cvg_designer/games_designed	games designed
/medicine/drug_ingredient/more_specific_ingredient	more specific ingredient
/protected_sites/protected_site/iucn_category	iucn category
/cvg/game_series/games_in_series	games in series
/visual_art/artwork/art_genre	art genre
/religion/religious_text/religious_text_of	religious text of
/religion/religion/notable_figures	notable figures
/award/ranked_list/ranked_list_items./award/ranking/item	item
/base/schemastaging/fish/found_in	found in
/military/armed_force/military_posts./military/military_post_use/military_post	military post
/spaceflight/space_agency/astronauts	astronauts
/base/parody/parodied_subject/parodies	parodies
/location/country/form_of_government	form of government
/biology/animal_breed/registered_with./biology/breed_registration/breed_group	breed group
/symbols/namesake/named_after	named after
/cvg/gameplay_mode/games_with_this_mode	games with this mode
/education/educational_institution/mascot	mascot
/base/contractbridge/bridge_player/teammates./base/contractbridge/bridge_player_teammates/teammate	teammate
/comic_books/comic_book_character/primary_universe	primary universe
/base/endorsements/endorsee/newspaper_endorsements./base/endorsements/newspaper_endorsement/newspaper	newspaper
/architecture/structure/architect	architect
/computer/computer_manufacturer_brand/computer_models	computer models
/base/parody/parody/parody_of	parody of
/people/ethnicity/includes_groups	includes groups
/aviation/aircraft_type/aircraft_of_this_type	aircraft of this type
/education/academic/advisors	advisors
/computer/programming_language/parent_language	parent language
/cvg/computer_videogame/gameplay_modes	gameplay modes
/location/hud_county_place/county	county
/film/film/executive_produced_by	executive produced by
/biology/organism_classification/organisms_of_this_type	organisms of this type
/user/alexander/philosophy/philosopher/interests	interests
/education/school/lowest_grade_taught	lowest grade taught
/film/film_art_director/films_art_directed	films art directed
/award/award_presenting_organization/award_categories_presented	award categories presented
/astronomy/celestial_object_category/objects	objects
/organization/organization/organization_type	organization type
/user/robert/us_congress/us_representative/committee_memberships	committee memberships
/base/biblioness/bibs_location/city	city
/military/military_combatant/military_conflicts./military/military_combatant_group/conflict	conflict
/base/newsevents/news_reporting_organisation/news_reports./base/newsevents/news_report/event	event
/book/literary_series/author_s	author s
/government/governmental_jurisdiction/agencies	agencies
/olympics/olympic_games/participating_countries	participating countries
/food/dietary_restriction/incompatible_ingredients	incompatible ingredients
/people/deceased_person/cause_of_death	cause of death
/sports/sports_team/championships	championships
/award/hall_of_fame_inductee/hall_of_fame_inductions./award/hall_of_fame_induction/hall_of_fame	hall of fame
/astronomy/orbital_relationship/orbited_by	orbited by
/royalty/noble_title/used_in./royalty/system_title_relationship/system	system
/organization/organization/companies_acquired./business/acquisition/company_acquired	company acquired
/film/producer/films_executive_produced	films executive produced
/film/film/costume_design_by	costume design by
/fictional_universe/fictional_character/based_on	based on
/transportation/bridge/locale	locale
/royalty/royal_line/monarchs_from_this_line	monarchs from this line
/royalty/noble_title/holders./royalty/noble_title_tenure/noble_person	noble person
/fictional_universe/work_of_fiction/setting	setting
/media_common/adapted_work/adaptations	adaptations
/religion/religion/organizations	organizations
/user/alexbl/honorary_title/titled_person/honorary_title./user/alexbl/honorary_title/honorary_title_holding/honorary_title	honorary title
/comic_books/comic_book_fictional_universe/characters_primarily_appearing_in_this_universe	characters primarily appearing in this universe
/language/human_language/countries_spoken_in	countries spoken in
/geography/island_group/islands_in_group	islands in group
/government/governmental_jurisdiction/official_symbols./location/location_symbol_relationship/symbol	symbol
/base/schemastaging/organization_extra/phone_number./base/schemastaging/phone_open_times/time_zone	time zone
/celebrities/celebrity/celebrity_friends./celebrities/friendship/friend	friend
/music/artist/label	label
/astronomy/star_system_body/star_system	star system
/transportation/bridge/bridge_type	bridge type
/base/activism/activism_issue/activists	activists
/religion/deity/deity_of	deity of
/celebrities/celebrity/sexual_orientation./celebrities/sexual_orientation_phase/sexual_orientation	sexual orientation
/sports/sport/leagues	leagues
/medicine/icd_9_cm_classification/includes_classifications	includes classifications
/user/alexander/misc/murdered_person/place_murdered	place murdered
/business/consumer_company/products./business/company_product_relationship/consumer_product	consumer product
/medicine/drug/drug_class	drug class
/education/educational_institution/subsidiary_or_constituent_schools	subsidiary or constituent schools
/organization/organization/acquired_by./business/acquisition/acquiring_company	acquiring company
/film/film_set_designer/film_sets_designed	film sets designed
/user/robert/us_congress/congressional_caucus/current_house_members	current house members
/education/academic/advisees	advisees
/film/film/directed_by	directed by
/government/governmental_jurisdiction/government_bodies	government bodies
/organization/non_profit_organization/registered_with./organization/non_profit_registration/registering_agency	registering agency
/user/robert/us_congress/house_committee/current_members	current members
/theater/theater_genre/plays_in_this_genre	plays in this genre
/influence/influence_node/peers./influence/peer_relationship/peers	peers
/location/us_county/county_seat	county seat
/government/governmental_body/sessions	sessions
/education/university/fraternities_and_sororities	fraternities and sororities
/fictional_universe/character_powers/characters_with_this_ability	characters with this ability
/finance/currency/countries_formerly_used	countries formerly used
/base/disaster2/tactic/attacks_of_this_form./base/disaster2/attack_process/attack_event	attack event
/comic_books/comic_book_publisher/comic_book_series_published	comic book series published
/fictional_universe/fictional_job_title/fictional_characters_with_this_job./fictional_universe/fictional_employment_tenure/employee	employee
/olympics/olympic_sport/olympic_games_contested	olympic games contested
/people/deceased_person/place_of_cremation	place of cremation
/tv/tv_genre/programs	programs
/royalty/order_of_chivalry/recipients./royalty/chivalric_order_membership/recipient	recipient
/film/film/film_production_design_by	film production design by
/film/film/other_film_companies./film/film_film_company_relationship/film_company	film company
/user/tsegaran/random/subject_taxonomy/entry./user/tsegaran/random/taxonomy_entry/subject	subject
/award/recurring_competition/individual_competitions	individual competitions
/location/country/second_level_divisions	second level divisions
/business/consumer_company/brands./business/company_brand_relationship/brand	brand
/protected_sites/governing_body_of_protected_sites/protected_sites_governed	protected sites governed
/user/tfmorris/default_domain/signatory/documents_signed	documents signed
/base/eating/practicer_of_diet/diet	diet
/travel/travel_destination/local_transportation	local transportation
/aviation/airline_alliance/member_airlines	member airlines
/base/crime/crime_victim/crime	crime
/food/ingredient/compatible_with_dietary_restrictions	compatible with dietary restrictions
/cvg/cvg_developer/games_developed	games developed
/fictional_universe/fictional_setting/fictional_characters_born_here	fictional characters born here
/architecture/type_of_museum/museums	museums
/location/place_with_neighborhoods/neighborhoods	neighborhoods
/aviation/aircraft_owner/aircraft_fleet_composition./aviation/aircraft_ownership_count/aircraft_model	aircraft model
/computer/software/software_genre	software genre
/visual_art/visual_artist/art_forms	art forms
/base/culturalevent/event/entity_involved	entity involved
/interests/collection_category/parent_category	parent category
/tennis/tennis_player/matches_won./tennis/tennis_match/loser	loser
/tv/tv_program/original_network./tv/tv_network_duration/network	network
/base/aareas/schema/administrative_area/administrative_area_type	administrative area type
/base/americancomedy/impersonated_celebrity/impersonated_by	impersonated by
/fictional_universe/fictional_universe/characters	characters
/organization/organization/geographic_scope	geographic scope
/media_common/literary_genre/books_in_this_genre	books in this genre
/aviation/airline/alliance	alliance
/base/bioventurist/science_or_technology_company/develops_treatments_for_disease	develops treatments for disease
/base/popstra/company/shopping_choice./base/popstra/shopping_choice/shopper	shopper
/organization/organization/spun_off_from./organization/organization_spin_off/parent_company	parent company
/base/infrastructure/power_station/fuel_type	fuel type
/architecture/architectural_style/architects	architects
/theater/play/lyricist	lyricist
/location/statistical_region/places_imported_from./location/imports_and_exports/imported_from	imported from
/film/film/story_by	story by
/education/educational_institution/parent_institution	parent institution
/location/neighborhood/neighborhood_of	neighborhood of
/organization/organization/place_founded	place founded
/law/judge/courts./law/judicial_tenure/court	court
/education/school_category/schools_of_this_kind	schools of this kind
/biology/organism_classification_rank/organism_classifications	organism classifications
/base/petbreeds/dog_breed/color	dog breed color
/film/film/language	film language
/organization/membership_organization/members./organization/organization_membership/member	organization membership member
/fictional_universe/fictional_character/children	fictional character children
/base/onephylogeny/type_of_thing/includes	type of thing includes
/fictional_universe/fictional_setting/works_set_here	fictional setting works set here
/people/person/gender	person gender
/broadcast/broadcast/area_served	broadcast area served
/computer/programming_language/dialects	programming language dialects
/book/newspaper/owner	newspaper owner
/religion/religion/includes	religion includes
/astronomy/celestial_object/category	celestial object category
/people/ethnicity/people	ethnicity people
/sports/school_sports_team/school	school sports team school
/biology/organism_classification/rank	organism classification rank
/award/long_list_nominee/long_list_nominations./award/long_list_nomination/award	long list nomination award
/base/popstra/celebrity/lived_with./base/popstra/lived_with/participant	lived with participant
/cvg/computer_videogame/subjects	computer videogame subjects
/language/language_family/languages	language family languages
/tv/tv_series_episode/series	tv series episode series
/language/language_writing_system/languages	language writing system languages
/fictional_universe/fictional_universe/works_set_here	fictional universe works set here
/base/marchmadness/ncaa_basketball_tournament/seeds./base/marchmadness/ncaa_tournament_seed/team	ncaa tournament seed team
/film/film/runtime./film/film_cut/film_release_region	film cut film release region
/music/genre/parent_genre	genre parent genre
/american_football/football_player/receiving./american_football/player_receiving_statistics/season	player receiving statistics season
/sports/pro_athlete/sports_played_professionally./sports/pro_sports_played/sport	pro sports played sport
/sports/multi_event_tournament/sports	multi event tournament sports
/american_football/football_player/rushing./american_football/player_rushing_statistics/team	player rushing statistics team
/tv/tv_series_season/series	tv series season series
/soccer/football_player/matches_played./soccer/football_player_match_participation/team	football player match participation team
/location/symbol_of_administrative_division/official_symbol_of./location/location_symbol_relationship/administrative_division	location symbol relationship administrative division
/award/award/category	award category
/sports/sports_award_winner/awards./sports/sports_award/team	sports award team
/tv/tv_program/subjects	tv program subjects
/dining/cuisine/restaurant	cuisine restaurant
/people/family_member/family	family member family
/film/writer/film	writer film
/sports/sport/pro_athletes./sports/pro_sports_played/athlete	pro sports played athlete
/education/educational_institution/colors	educational institution colors
/tv/tv_program/country_of_origin	tv program country of origin
/language/language_dialect/language	language dialect language
/american_football/football_player/rushing./american_football/player_rushing_statistics/season	player rushing statistics season
/base/biblioness/bibs_location/state	bibs location state
/organization/organization/phone_number./common/phone_number/service_location	phone number service location
/base/aareas/schema/administrative_area/capital	administrative area capital
/dining/cuisine/ingredients	cuisine ingredients
/base/thoroughbredracing/thoroughbred_racehorse/country	thoroughbred racehorse country
/basketball/basketball_position/players	basketball position players
/sports/sports_team/season_record./sports/sports_team_season_record/season	sports team season record season
/military/military_combatant/casualties./military/casualties/military_conflict	casualties military conflict
/comic_books/comic_book_series/created_by	comic book series created by
/architecture/structure/construction_cost./measurement_unit/money_value/currency	money value currency
/cvg/computer_videogame/sequel	computer videogame sequel
/base/popstra/celebrity/endorsements./base/popstra/paid_support/company	paid support company
/geography/lake/cities	lake cities
/visual_art/visual_art_form/artists	visual art form artists
/government/government_office_or_title/category	government office or title category
/tv/tv_producer/tv_episodes_produced./tv/tv_producer_episode_credit/episode	tv producer episode credit episode
/film/film_festival/location	film festival location
/people/family/country	family country
/cvg/computer_videogame/developer	computer videogame developer
/organization/organization_member/member_of./organization/organization_membership/organization	organization membership organization
/media_common/media_genre/parent_genre	media genre parent genre
/geography/geographical_feature/category	geographical feature category
/music/performance_role/track_performances./music/track_contribution/contributor	track contribution contributor
/book/written_work/subjects	written work subjects
/architecture/architect/architectural_style	architect architectural style
/user/robert/us_congress/us_representative/state	us representative state
/projects/project_participant/projects./projects/project_participation/role	project participation role
/film/film/country	film country
/people/cause_of_death/people	cause of death people
/sports/sports_league/teams./sports/sports_league_participation/team	sports league participation team
/base/schemastaging/organization_extra/phone_number./base/schemastaging/phone_sandbox/service_location	phone sandbox service location
/government/government_office_or_title/jurisdiction	government office or title jurisdiction
/film/film_festival_event/films	film festival event films
/comic_books/comic_book_character/created_by	comic book character created by
/dining/cuisine/dishes	cuisine dishes
/organization/organization/headquarters./location/mailing_address/country	mailing address country
/film/film/film_format	film film format
/film/film_format/film_format	film format film format
/medicine/disease_cause/diseases	disease cause diseases
/tennis/tennis_player/matches_lost./tennis/tennis_match/winner	tennis match winner
/tv/tv_actor/guest_roles./tv/tv_guest_role/special_performance_type	tv guest role special performance type
/film/film/distributors./film/film_film_distributor_relationship/distributor	film film distributor relationship distributor
/tv/tv_program/recurring_writers./tv/tv_program_writer_relationship/writer	tv program writer relationship writer
/film/film/release_date_s./film/film_regional_release_date/film_release_region	film regional release date film release region
/music/performance_role/guest_performances./music/recording_contribution/contributor	recording contribution contributor
/base/popstra/celebrity/friendship./base/popstra/friendship/participant	friendship participant
/broadcast/tv_station/owner	tv station owner
/venture_capital/venture_investor/investments./venture_capital/venture_investment/company	venture investment company
/baseball/baseball_team/team_stats./baseball/baseball_team_stats/season	baseball team stats season
/base/schemastaging/athlete_extra/salary./base/schemastaging/athlete_salary/team	athlete salary team
/sports/sports_facility/teams	sports facility teams
/visual_art/visual_art_form/artworks	visual art form artworks
/american_football/football_player/passing./american_football/player_passing_statistics/season	player passing statistics season
/sports/sports_championship/events	sports championship events
/user/hangy/default_domain/sports_team_gender/gender	sports team gender gender
/education/academic_institution/visiting_scholars_fellows_etc./education/academic_post/person	academic post person
/base/collectives/collective/members./base/collectives/collective_membership/member	collective membership member
/tv/tv_program/genre	tv program genre
/medicine/risk_factor/diseases	risk factor diseases
/theater/play/country_of_origin	play country of origin
/base/schemastaging/person_extra/net_worth./measurement_unit/dated_money_value/source	dated money value source
/broadcast/content/language	content language
/education/academic/appointments_fellowships_etc./education/academic_post/institution	academic post institution
/cvg/computer_videogame/prequel	computer videogame prequel
/music/genre/albums	genre albums
/music/album/genre	album genre
/food/dish/ingredients	dish ingredients
/tennis/tennis_tournament_champion/tennis_titles./tennis/tennis_tournament_championship/winner	tennis tournament championship winner
/music/instrument/family	instrument family
/user/szaijan/fantasy_football/player/position	player position
/base/yalebase/secret_society/notable_members./base/yalebase/secret_society_membership/member	secret society membership member
/soccer/football_team_manager/team./soccer/football_team_management_tenure/team	football team management tenure team
/computer/programming_language/influenced_by	programming language influenced by
/sports/sports_team/league./sports/sports_league_participation/league	sports league participation league
/religion/place_of_worship/religion	place of worship religion
/people/ethnicity/languages_spoken	ethnicity languages spoken
/soccer/football_league/teams./soccer/football_league_participation/team	football league participation team
/film/film/distributors./film/film_film_distributor_relationship/region	film film distributor relationship region
/base/petbreeds/dog_breed/group	dog breed group
/film/film/genre	film genre
/fictional_universe/fictional_character/parents	fictional character parents
/military/military_combatant/force_deployments./military/force_strength/military_conflict	force strength military conflict
/baseball/baseball_player/batting_stats./baseball/batting_statistics/season	batting statistics season
/baseball/baseball_position/players	baseball position players
/fictional_universe/fictional_character/rank	fictional character rank
/book/periodical/subjects	periodical subjects
/common/topic/subjects	topic subjects
/metropolitan_transit/transit_system/area_served	transit system area served
/tv/tv_series_episode/writer	tv series episode writer
/tv/tv_program_guest/appeared_on./tv/tv_guest_personal_appearance/appearance_type	tv guest personal appearance appearance type
/music/record_label/artist	record label artist
/film/director/film	director film
/celebrities/sexual_orientation/celebrities./celebrities/sexual_orientation_phase/celebrity	sexual orientation phase celebrity
/architecture/structure/owner./architecture/ownership/owner	ownership owner
/baseball/baseball_team/league	baseball team league
/basketball/basketball_player/player_statistics./basketball/basketball_player_stats/team	basketball player stats team
/people/person/children	person children
/award/hall_of_fame_inductee/hall_of_fame_inductions./award/hall_of_fame_induction/category	hall of fame induction category
/food/ingredient/dishes	ingredient dishes
/sports/sports_team/colors	sports team colors
/internet/website/owner_new./internet/website_ownership/owner	website ownership owner
/location/administrative_division/country	administrative division country
/fictional_universe/fictional_character/ethnicity	fictional character ethnicity
/film/production_company/films	production company films
/base/wrestling/solo_wrestler_or_team/members	solo wrestler or team members
/organization/organization/phone_number./common/phone_number/category	phone number category
/theater/play/genre	play genre
/base/popstra/celebrity/vacations_in./base/popstra/vacation_choice/location	vacation choice location
/base/thoroughbredracing/thoroughbred_racehorse/sex	thoroughbred racehorse sex
/people/person/ethnicity	person ethnicity
/user/robert/us_congress/congressional_district/state	congressional district state
/broadcast/radio_station/owner	radio station owner
/broadcast/broadcast/distributor	broadcast distributor
/language/human_language/dialects	human language dialects
/film/film/subjects	film subjects
/religion/religious_leader/religious_leadership./religion/religious_organization_leadership/organization	religious organization leadership organization
/base/schemastaging/athlete_extra/salary./base/schemastaging/athlete_salary/currency	athlete salary currency
/base/popstra/celebrity/eats_at./base/popstra/restaurant_choice/restaurant	restaurant choice restaurant
/geography/lake/basin_countries	lake basin countries
/education/fraternity_sorority/colors	fraternity sorority colors
/education/school_mascot/school	school mascot school
/broadcast/content/genre	content genre
/broadcast/artist/content	artist content
/base/localfood/produce/availability./base/localfood/produce_availability/location	produce availability location
/people/person/parents	person parents
/user/alexander/philosophy/era/philosophers	era philosophers
/fictional_universe/fictional_character/gender	fictional character gender
/baseball/baseball_player/position_s	baseball player position s
/user/szaijan/fantasy_football/position/player	position player
/internet/website/category	website category
/base/popstra/celebrity/breakup./base/popstra/breakup/participant	breakup participant
/baseball/baseball_league/teams	baseball league teams
/theater/theater_character/portrayed_by./theater/theater_role/actor	theater role actor
/architecture/structure/architectural_style	structure architectural style
/base/famouspets/pet_owner/pets_owned./base/famouspets/pet_ownership/owner	pet ownership owner
/base/popstra/celebrity/canoodled./base/popstra/canoodled/participant	canoodled participant
/broadcast/genre/content	genre content
/computer/software/compatible_oses./computer/software_compatibility/operating_system	software compatibility operating system
/military/military_conflict/casualties./military/casualties/combatant	casualties combatant
/location/statistical_region/religions./location/religion_percentage/religion	religion percentage religion
/people/person/place_of_birth	person place of birth
/base/petbreeds/dog_breed/size./base/petbreeds/dog_size/gender	dog size gender
/soccer/football_team/league./soccer/football_league_participation/league	football league participation league
/influence/influence_node/influenced_by	influence node influenced by
/base/thoroughbredracing/thoroughbred_racehorse/color	thoroughbred racehorse color
/location/capital_of_administrative_division/capital_of./location/administrative_division_capital_relationship/administrative_division	administrative division capital relationship administrative division
/sports/tournament_event_competitor/events_competed_in./sports/competitor_competition_relationship/country	competitor competition relationship country
/tv/tv_actor/guest_roles./tv/tv_guest_role/character	tv guest role character
/film/film_company/films./film/film_film_company_relationship/film	film film company relationship film
/fictional_universe/fictional_character/place_of_birth	fictional character place of birth
/tv/tv_program/languages	tv program languages
/basketball/basketball_player/position_s	basketball player position s
/comic_books/comic_book_series/publisher	comic book series publisher
/film/cinematographer/film	cinematographer film
/book/book/genre	book genre
/music/artist/genre	artist genre
/people/person/languages	person languages
/projects/project_role/projects./projects/project_participation/participant	project participation participant
/american_football/football_player/passing./american_football/player_passing_statistics/team	player passing statistics team
/broadcast/content/producer	content producer
/film/producer/film	producer film
/base/activism/activist/area_of_activism	activist area of activism
/location/country/languages_spoken	country languages spoken
/american_football/football_player/games./american_football/player_game_statistics/team	player game statistics team
/language/human_language/region	human language region
/baseball/baseball_player/batting_stats./baseball/batting_statistics/team	batting statistics team
/government/government_agency/jurisdiction	government agency jurisdiction
/base/marchmadness/ncaa_basketball_team/ncaa_tournament_seeds./base/marchmadness/ncaa_tournament_seed/tournament	ncaa tournament seed tournament
/location/location/events	location events
/book/periodical/publisher./book/periodical_publisher_period/publisher	periodical publisher period publisher
/tv/tv_program_guest/appeared_on./tv/tv_guest_personal_appearance/episode	tv guest personal appearance episode
/people/family/members	family members
/base/usnationalparks/us_national_park/state	us national park state
/people/person/places_lived./people/place_lived/location	place lived location
/visual_art/visual_art_genre/artworks	visual art genre artworks
/tv/tv_network/programs./tv/tv_network_duration/program	tv network duration program
/film/film_subject/films	film subject films
/broadcast/broadcast/content	broadcast content
/geography/river/basin_countries	river basin countries
/business/asset/owners./business/asset_ownership/owner	asset ownership owner
/base/americancomedy/comedy_group_member/belongs_to./base/americancomedy/comedy_group_membership/group	comedy group membership group
/computer/software/developer	software developer
/music/concert_tour/artist	concert tour artist
/government/governmental_body/jurisdiction	governmental body jurisdiction
/base/popstra/celebrity/shops_at./base/popstra/shopping_choice/company	shopping choice company
/user/alexander/philosophy/subject/philosophers	subject philosophers
/base/petbreeds/dog_breed/cities_where_this_dog_is_popular./base/petbreeds/dog_city_relationship/cities	dog city relationship cities
/broadcast/content/artist	content artist
/celebrities/celebrity/sexual_relationships./celebrities/romantic_relationship/celebrity	romantic relationship celebrity
/music/album/artist	album artist
/american_football/football_player/receiving./american_football/player_receiving_statistics/team	player receiving statistics team
/sports/sports_team_location/teams	sports team location teams
/base/biblioness/bibs_location/country	bibs location country
/computer/programming_language_paradigm/languages	programming language paradigm languages
/cvg/cvg_genre/games	cvg genre games
/film/film/prequel	film prequel
/book/magazine/genre	magazine genre
/location/country/capital	country capital
/medicine/type_of_infectious_agent/diseases	type of infectious agent diseases
/influence/influence_node/influenced	influence node influenced
/food/dish/cuisine	dish cuisine
/film/film/sequel	film sequel
/base/popstra/celebrity/religion./base/popstra/religion_choice/religion	religion choice religion
/film/editor/film	editor film
/sports/sport/teams	sport teams
/royalty/system_of_nobility/titles./royalty/system_title_relationship/title	system title relationship title
/sports/sports_team/location	sports team location
/food/ingredient/cuisine	ingredient cuisine
/book/periodical_publisher/periodicals_published./book/periodical_publisher_period/periodical	periodical publisher period periodical
/education/educational_institution/sexes_accepted./education/gender_enrollment/sex	gender enrollment sex
/base/popstra/celebrity/dated./base/popstra/dated/participant	dated participant
/book/periodical_format/periodicals_in_this_format./book/periodical_format_period/periodical	periodical format period periodical
/base/activism/organization/area_of_activism	organization area of activism
/geography/river/cities	river cities
/biology/organism/sex	organism sex
/base/petbreeds/dog_breed_group/dog_breeds	dog breed group dog breeds
/music/album_release_type/albums	album release type albums
/american_football/football_player/games./american_football/player_game_statistics/season	player game statistics season
/music/genre/artists	genre artists
/sports/sports_team/sport	sports team sport
/computer/programming_language/influenced	programming language influenced
/base/x2010fifaworldcupsouthafrica/world_cup_squad/current_world_cup_squad./base/x2010fifaworldcupsouthafrica/current_world_cup_squad/players	current world cup squad players
/base/petbreeds/dog_coat_color/dog_breeds	dog coat color dog breeds
/location/administrative_division/capital./location/administrative_division_capital_relationship/capital	administrative division capital relationship capital
/sports/sports_league/sport	sports league sport
/fictional_universe/fictional_character/employers./fictional_universe/fictional_employment_tenure/title	fictional employment tenure title
/dining/restaurant/cuisine	restaurant cuisine
/broadcast/content/location	content location
/cvg/computer_game_subject/games	computer game subject games
/user/tsegaran/computer/algorithm/family	algorithm family
/computer/computer/compatible_oses./computer/os_compatibility/operating_system	os compatibility operating system
/business/consumer_product/company./business/company_product_relationship/company	company product relationship company
/base/americancomedy/comedy_group/members./base/americancomedy/comedy_group_membership/member	comedy group membership member
/computer/operating_system/developer	operating system developer
/tv/tv_series_episode/producers./tv/tv_producer_episode_credit/producer	tv producer episode credit producer
/business/brand/owner_s./business/company_brand_relationship/company	company brand relationship company
/ice_hockey/hockey_position/players	hockey position players
/cvg/computer_videogame/publisher	computer videogame publisher
/tv/tv_program/seasons	tv program seasons
/people/person/religion	person religion
/base/popstra/religion/membership./base/popstra/religion_choice/member	religion choice member
/location/it_province/capital	it province capital
/film/music_contributor/film	music contributor film
/theater/theater_actor/theater_roles./theater/theater_role/role	theater role role
/american_football/football_player/position_s	american football football player position s
/sports/sports_official/sport	sports sports official sport
/soccer/football_player/position_s	soccer football player position s
/base/fight/sports_official/sport	fight sports official sport
/olympics/olympic_games/sports	olympics olympic games sports
/user/jg/default_domain/olympic_games/sports	default domain olympic games sports
/soccer/football_position/players	soccer football position players
/american_football/football_position/players	american football football position players
/music/group_member/membership./music/group_membership/group	membership. music group membership group
/education/educational_degree/people_with_this_degree./education/education/student	people with this degree. education education student
/common/webpage/category	 common webpage category
/tv/tv_program/regular_personal_appearances./tv/tv_regular_personal_appearance/person	regular personal appearances. tv tv regular personal appearance person
/olympics/olympic_medal/medal_winners./olympics/olympic_medal_honor/olympics	medal winners. olympics olympic medal honor olympics
/cvg/game_voice_actor/computer_game_voice_performances./cvg/game_performance/character	computer game voice performances. cvg game performance character
/education/university/local_tuition./measurement_unit/dated_money_value/currency	local tuition. measurement unit dated money value currency
/sports/sports_team/roster./soccer/football_roster_position/position	roster. soccer football roster position position
/people/appointed_role/appointment./people/appointment/appointed_by	appointment. people appointment appointed by
/government/political_district/representatives./government/government_position_held/office_holder	representatives. government government position held office holder
/film/actor/dubbing_performances./film/dubbing_performance/film	dubbing performances. film dubbing performance film
/tv/tv_producer_type/tv_producers_of_this_type./tv/tv_producer_term/program	tv producers of this type. tv tv producer term program
/film/film_character/portrayed_in_films_dubbed./film/dubbing_performance/film	portrayed in films dubbed. film dubbing performance film
/sports/drafted_athlete/drafted./sports/sports_league_draft_pick/school	drafted. sports sports league draft pick school
/sports/sports_position/players./basketball/basketball_roster_position/team	players. basketball basketball roster position team
/people/person/education./education/education/major_field_of_study	education. education education major field of study
/music/musical_group/member./music/group_membership/role	member. music group membership role
/education/educational_degree/people_with_this_degree./education/education/specialization	people with this degree. education education specialization
/business/employer/employees./business/employment_tenure/title	employees. business employment tenure title
/sports/pro_athlete/teams./american_football/football_historical_roster_position/team	teams. american football football historical roster position team
/film/film_crewmember/films_crewed./film/film_crew_gig/film_crew_role	films crewed. film film crew gig film crew role
/government/government_office_or_title/office_holders./government/government_position_held/office_holder	office holders. government government position held office holder
/business/board_member/organization_board_memberships./organization/organization_board_membership/organization	organization board memberships. organization organization board membership organization
/business/business_operation/current_liabilities./measurement_unit/dated_money_value/currency	current liabilities. measurement unit dated money value currency
/basketball/basketball_position/player_roster_position./basketball/basketball_roster_position/player	player roster position. basketball basketball roster position player
/sports/pro_athlete/teams./american_football/football_historical_roster_position/position_s	teams. american football football historical roster position position s
/american_football/football_team/historical_coaching_staff./american_football/football_historical_coach_position/coach	historical coaching staff. american football football historical coach position coach
/music/artist/track_contributions./music/track_contribution/role	track contributions. music track contribution role
/soccer/football_team/current_roster./soccer/football_roster_position/position	current roster. soccer football roster position position
/education/educational_degree/people_with_this_degree./education/education/minor	people with this degree. education education minor
/award/award_category/winners./award/award_honor/award_winner	winners. award award honor award winner
/sports/pro_athlete/teams./ice_hockey/hockey_roster_position/team	teams. ice hockey hockey roster position team
/award/award_category/winners./award/award_honor/honored_for	winners. award award honor honored for
/tv/tv_producer/programs_produced./tv/tv_producer_term/program	programs produced. tv tv producer term program
/film/film/personal_appearances./film/personal_film_appearance/person	personal appearances. film personal film appearance person
/tv/non_character_role/tv_regular_personal_appearances./tv/tv_regular_personal_appearance/person	tv regular personal appearances. tv tv regular personal appearance person
/tv/tv_character/appeared_in_tv_program./tv/regular_tv_appearance/special_performance_type	appeared in tv program. tv regular tv appearance special performance type
/transportation/road/end2./transportation/road_starting_point/location	end2. transportation road starting point location
/basketball/basketball_position/player_roster_position./sports/sports_team_roster/team	player roster position. sports sports team roster team
/education/educational_degree/people_with_this_degree./education/education/institution	people with this degree. education education institution
/cvg/game_character/games./cvg/game_performance/voice_actor	games. cvg game performance voice actor
/olympics/olympic_games/medals_awarded./olympics/olympic_medal_honor/medal	medals awarded. olympics olympic medal honor medal
/organization/role/leaders./organization/leadership/organization	leaders. organization leadership organization
/organization/organization/involved_in_merger./organization/organization_merger/organizations_merging	involved in merger. organization organization merger organizations merging
/sports/sports_position/players./baseball/baseball_roster_position/team	players. baseball baseball roster position team
/tv/tv_actor/starring_roles./tv/regular_tv_appearance/seasons	starring roles. tv regular tv appearance seasons
/government/government_office_or_title/office_holders./government/government_position_held/appointed_by	office holders. government government position held appointed by
/government/political_district/representatives./government/government_position_held/legislative_sessions	representatives. government government position held legislative sessions
/government/governmental_jurisdiction/governing_officials./government/government_position_held/office_holder	governing officials. government government position held office holder
/film/actor/film./film/performance/film	film. film performance film
/business/board_member/leader_of./organization/leadership/organization	leader of. organization leadership organization
/government/governmental_body/members./government/government_position_held/appointed_by	members. government government position held appointed by
/award/award_ceremony/awards_presented./award/award_honor/award	awards presented. award award honor award
/tv/tv_program/regular_cast./tv/regular_tv_appearance/special_performance_type	regular cast. tv regular tv appearance special performance type
/location/location/street_address./location/mailing_address/state_province_region	street address. location mailing address state province region
/military/rank/used_by_services./military/military_service/military_person	used by services. military military service military person
/sports/sports_position/players./ice_hockey/hockey_roster_position/player	players. ice hockey hockey roster position player
/film/film/starring./film/performance/actor	starring. film performance actor
/music/performance_role/guest_performances./music/recording_contribution/performance_role	guest performances. music recording contribution performance role
/organization/role/leaders./organization/leadership/person	leaders. organization leadership person
/sports/sports_team/roster./ice_hockey/hockey_roster_position/position	roster. ice hockey hockey roster position position
/government/political_district/representatives./government/government_position_held/jurisdiction_of_office	representatives. government government position held jurisdiction of office
/government/political_appointer/appointees./government/government_position_held/governmental_body	appointees. government government position held governmental body
/music/performance_role/regular_performances./music/group_membership/group	regular performances. music group membership group
/exhibitions/exhibition_sponsor/exhibitions_sponsored./exhibitions/exhibition_run/sponsor	exhibitions sponsored. exhibitions exhibition run sponsor
/government/government_office_category/officeholders./government/government_position_held/jurisdiction_of_office	officeholders. government government position held jurisdiction of office
/film/film/starring./film/performance/special_performance_type	starring. film performance special performance type
/sports/pro_athlete/teams./baseball/baseball_historical_roster_position/team	teams. baseball baseball historical roster position team
/government/politician/government_positions_held./government/government_position_held/office_position_or_title	government positions held. government government position held office position or title
/american_football/football_coach_position/coaches_holding_this_position./american_football/football_historical_coach_position/team	coaches holding this position. american football football historical coach position team
/film/film/starring./film/performance/character	starring. film performance character
/sports/sports_league_season/awards./sports/sports_award/award_winner	awards. sports sports award award winner
/government/government_office_category/officeholders./government/government_position_held/governmental_body	officeholders. government government position held governmental body
/media_common/dedicatee/dedications./media_common/dedication/dedicated_by	dedications. media common dedication dedicated by
/organization/organization/leadership./organization/leadership/person	leadership. organization leadership person
/common/topic/webpage./common/webpage/category	webpage. common webpage category
/olympics/olympic_games/medals_awarded./olympics/olympic_medal_honor/medalist	medals awarded. olympics olympic medal honor medalist
/people/appointer/appointment_made./people/appointment/appointee	appointment made. people appointment appointee
/basketball/basketball_player/former_teams./basketball/basketball_historical_roster_position/team	former teams. basketball basketball historical roster position team
/american_football/football_team/historical_roster./sports/sports_team_roster/position	historical roster. sports sports team roster position
/sports/sports_position/players./ice_hockey/hockey_roster_position/team	players. ice hockey hockey roster position team
/military/military_conflict/commanders./military/military_command/military_commander	commanders. military military command military commander
/government/political_district/representatives./government/government_position_held/basic_title	representatives. government government position held basic title
/american_football/football_team/historical_roster./american_football/football_historical_roster_position/player	historical roster. american football football historical roster position player
/sports/sports_team/roster./american_football/football_historical_roster_position/position_s	roster. american football football historical roster position position s
/education/field_of_study/students_majoring./education/education/minor	students majoring. education education minor
/people/person/education./education/education/institution	education. education education institution
/olympics/olympic_athlete/country./olympics/olympic_athlete_affiliation/sport	country. olympics olympic athlete affiliation sport
/people/marriage_union_type/unions_of_this_type./people/marriage/location_of_ceremony	unions of this type. people marriage location of ceremony
/sports/pro_athlete/teams./american_football/football_roster_position/team	teams. american football football roster position team
/sports/sports_team/roster./basketball/basketball_historical_roster_position/player	roster. basketball basketball historical roster position player
/government/legislative_session/members./government/government_position_held/governmental_body	members. government government position held governmental body
/sports/sports_position/players./soccer/football_roster_position/team	players. soccer football roster position team
/government/politician/government_positions_held./government/government_position_held/jurisdiction_of_office	government positions held. government government position held jurisdiction of office
/government/political_district/representatives./government/government_position_held/governmental_body	representatives. government government position held governmental body
/business/business_operation/retained_earnings./measurement_unit/dated_money_value/currency	retained earnings. measurement unit dated money value currency
/film/film_character/portrayed_in_films_dubbed./film/dubbing_performance/language	portrayed in films dubbed. film dubbing performance language
/people/appointee/position./people/appointment/appointed_by	position. people appointment appointed by
/government/political_appointer/appointees./government/government_position_held/basic_title	appointees. government government position held basic title
/sports/sports_position/players./sports/sports_team_roster/player	players. sports sports team roster player
/ice_hockey/hockey_player/current_team./ice_hockey/hockey_roster_position/team	current team. ice hockey hockey roster position team
/military/military_conflict/commanders./military/military_command/military_combatant	commanders. military military command military combatant
/military/military_combatant/military_commanders./military/military_command/military_conflict	military commanders. military military command military conflict
/education/university/domestic_tuition./measurement_unit/dated_money_value/currency	domestic tuition. measurement unit dated money value currency
/baseball/baseball_player/current_team./baseball/baseball_roster_position/team	current team. baseball baseball roster position team
/location/statistical_region/gdp_nominal./measurement_unit/dated_money_value/currency	gdp nominal. measurement unit dated money value currency
/business/business_operation/net_profit./measurement_unit/dated_money_value/currency	net profit. measurement unit dated money value currency
/travel/transport_operator/travel_destinations_served./travel/transportation/transport_operator	travel destinations served. travel transportation transport operator
/sports/sports_position/players./basketball/basketball_roster_position/player	players. basketball basketball roster position player
/people/appointer/appointment_made./people/appointment/appointed_role	appointment made. people appointment appointed role
/military/military_person/service./military/military_service/military_force	service. military military service military force
/film/special_film_performance_type/film_performance_type./film/performance/film	film performance type. film performance film
/sports/pro_athlete/teams./ice_hockey/hockey_roster_position/position	teams. ice hockey hockey roster position position
/film/special_film_performance_type/film_performance_type./film/performance/character	film performance type. film performance character
/business/job_title/people_with_this_title./business/employment_tenure/company	people with this title. business employment tenure company
/military/military_commander/military_commands./military/military_command/military_combatant	military commands. military military command military combatant
/film/person_or_entity_appearing_in_film/films./film/personal_film_appearance/type_of_appearance	films. film personal film appearance type of appearance
/location/location/street_address./location/mailing_address/citytown	street address. location mailing address citytown
/basketball/basketball_player/team./basketball/basketball_roster_position/team	team. basketball basketball roster position team
/travel/transport_terminus/travel_destinations_served./travel/transportation/transport_terminus	travel destinations served. travel transportation transport terminus
/common/webpage/topic	 common webpage topic
/american_football/football_coach/coaching_history./american_football/football_historical_coach_position/team	coaching history. american football football historical coach position team
/film/actor/film./film/performance/character	film. film performance character
/people/person/spouse_s./people/marriage/spouse	spouse s. people marriage spouse
/business/job_title/people_with_this_title./business/employment_tenure/person	people with this title. business employment tenure person
/american_football/football_player/former_teams./american_football/football_historical_roster_position/position_s	former teams. american football football historical roster position position s
/people/person/employment_history./business/employment_tenure/title	employment history. business employment tenure title
/music/artist/contribution./music/recording_contribution/performance_role	contribution. music recording contribution performance role
/government/government_office_category/officeholders./government/government_position_held/office_position_or_title	officeholders. government government position held office position or title
/tv/tv_character/appeared_in_tv_program./tv/regular_tv_appearance/series	appeared in tv program. tv regular tv appearance series
/sports/sports_position/players./american_football/football_historical_roster_position/position_s	players. american football football historical roster position position s
/organization/organization/product_of_merger./organization/organization_merger/organizations_merging	product of merger. organization organization merger organizations merging
/education/educational_institution/students_graduates./education/education/degree	students graduates. education education degree
/music/performance_role/regular_performances./music/group_membership/member	regular performances. music group membership member
/film/film_job/films_with_this_crew_job./film/film_crew_gig/crewmember	films with this crew job. film film crew gig crewmember
/education/educational_degree/people_with_this_degree./education/education/major_field_of_study	people with this degree. education education major field of study
/government/government_office_or_title/office_holders./government/government_position_held/legislative_sessions	office holders. government government position held legislative sessions
/common/resource/annotations./common/webpage/category	annotations. common webpage category
/baseball/baseball_team/historical_roster./baseball/baseball_historical_roster_position/player	historical roster. baseball baseball historical roster position player
/tv/tv_program/regular_cast./tv/regular_tv_appearance/character	regular cast. tv regular tv appearance character
/american_football/football_player/former_teams./american_football/football_historical_roster_position/team	former teams. american football football historical roster position team
/film/film/other_crew./film/film_crew_gig/crewmember	other crew. film film crew gig crewmember
/education/field_of_study/students_majoring./education/education/degree	students majoring. education education degree
/film/film/dubbing_performances./film/dubbing_performance/actor	dubbing performances. film dubbing performance actor
/tv/tv_actor/starring_roles./tv/regular_tv_appearance/special_performance_type	starring roles. tv regular tv appearance special performance type
/tv/tv_actor/starring_roles./tv/regular_tv_appearance/character	starring roles. tv regular tv appearance character
/location/statistical_region/rent50_2./measurement_unit/dated_money_value/currency	rent50 2. measurement unit dated money value currency
/sports/sports_team/roster./american_football/football_roster_position/player	roster. american football football roster position player
/american_football/football_player/current_team./american_football/football_roster_position/team	current team. american football football roster position team
/location/hud_foreclosure_area/total_residential_addresses./measurement_unit/dated_integer/source	total residential addresses. measurement unit dated integer source
/american_football/football_player/former_teams./sports/sports_team_roster/position	former teams. sports sports team roster position
/people/marriage_union_type/unions_of_this_type./people/marriage/spouse	unions of this type. people marriage spouse
/biology/breed_registry/recognized_breeds./biology/breed_registration/breed	recognized breeds. biology breed registration breed
/sports/sports_position/players./american_football/football_roster_position/team	players. american football football roster position team
/sports/pro_athlete/teams./basketball/basketball_roster_position/team	teams. basketball basketball roster position team
/tv/tv_personality/tv_regular_appearances./tv/tv_regular_personal_appearance/program	tv regular appearances. tv tv regular personal appearance program
/music/performance_role/track_performances./music/track_contribution/role	track performances. music track contribution role
/tv/tv_character/appeared_in_tv_program./tv/regular_tv_appearance/actor	appeared in tv program. tv regular tv appearance actor
/organization/organization/board_members./organization/organization_board_membership/member	board members. organization organization board membership member
/film/film_character/portrayed_in_films./film/performance/film	portrayed in films. film performance film
/business/business_operation/cash./measurement_unit/dated_money_value/currency	cash. measurement unit dated money value currency
/olympics/olympic_athlete/country./olympics/olympic_athlete_affiliation/country	country. olympics olympic athlete affiliation country
/tv/tv_character/appeared_in_tv_episodes./tv/tv_guest_role/actor	appeared in tv episodes. tv tv guest role actor
/media_common/dedicator/dedications./media_common/dedication/dedicated_to	dedications. media common dedication dedicated to
/baseball/baseball_team/current_roster./baseball/baseball_roster_position/player	current roster. baseball baseball roster position player
/music/group_member/membership./music/group_membership/role	membership. music group membership role
/location/statistical_region/rent50_3./measurement_unit/dated_money_value/currency	rent50 3. measurement unit dated money value currency
/sports/pro_athlete/teams./sports/sports_team_roster/position	teams. sports sports team roster position
/olympics/olympic_medal/medal_winners./olympics/olympic_medal_honor/medalist	medal winners. olympics olympic medal honor medalist
/baseball/baseball_team/current_roster./baseball/baseball_roster_position/position	current roster. baseball baseball roster position position
/organization/role/governors./organization/organization_board_membership/member	governors. organization organization board membership member
/award/award_ceremony/awards_presented./award/award_honor/award_winner	awards presented. award award honor award winner
/basketball/basketball_player/team./sports/sports_team_roster/team	team. sports sports team roster team
/film/film_character/portrayed_in_films_dubbed./film/dubbing_performance/actor	portrayed in films dubbed. film dubbing performance actor
/sports/sports_award_winner/awards./sports/sports_award/season	awards. sports sports award season
/cvg/computer_videogame/characters./cvg/game_performance/voice_actor	characters. cvg game performance voice actor
/sports/sports_position/players./sports/sports_team_roster/position	players. sports sports team roster position
/government/government_office_category/officeholders./government/government_position_held/legislative_sessions	officeholders. government government position held legislative sessions
/cvg/game_voice_actor/computer_game_voice_performances./cvg/game_performance/game	computer game voice performances. cvg game performance game
/aviation/airline/airports_served./aviation/airline_airport_presence/cities_served	airports served. aviation airline airport presence cities served
/education/educational_institution/students_graduates./education/education/student	students graduates. education education student
/ice_hockey/hockey_player/former_team_s./ice_hockey/hockey_previous_roster_position/team	former team s. ice hockey hockey previous roster position team
/people/appointee/position./people/appointment/appointed_role	position. people appointment appointed role
/basketball/basketball_team/historical_roster./basketball/basketball_historical_roster_position/player	historical roster. basketball basketball historical roster position player
/travel/travel_destination/how_to_get_here./travel/transportation/mode_of_transportation	how to get here. travel transportation mode of transportation
/american_football/football_player/current_team./american_football/football_roster_position/position	current team. american football football roster position position
/baseball/baseball_player/current_team./baseball/baseball_roster_position/position	current team. baseball baseball roster position position
/protected_sites/natural_or_cultural_site_designation/sites./protected_sites/natural_or_cultural_site_listing/listed_site	sites. protected sites natural or cultural site listing listed site
/award/award_category/winners./award/award_honor/ceremony	winners. award award honor ceremony
/american_football/football_team/current_roster./american_football/football_roster_position/position	current roster. american football football roster position position
/sports/sports_award_type/winners./sports/sports_award/season	winners. sports sports award season
/location/statistical_region/rent50_1./measurement_unit/dated_money_value/currency	rent50 1. measurement unit dated money value currency
/military/armed_force/personnel./military/military_service/rank	personnel. military military service rank
/film/film_character/portrayed_in_films./film/performance/special_performance_type	portrayed in films. film performance special performance type
/government/politician/government_positions_held./government/government_position_held/appointed_by	government positions held. government government position held appointed by
/government/governmental_jurisdiction/governing_officials./government/government_position_held/legislative_sessions	governing officials. government government position held legislative sessions
/education/field_of_study/students_majoring./education/education/specialization	students majoring. education education specialization
/business/business_operation/liabilities./measurement_unit/dated_money_value/currency	liabilities. measurement unit dated money value currency
/basketball/basketball_position/player_roster_position./sports/sports_team_roster/player	player roster position. sports sports team roster player
/tv/tv_series_episode/guest_personal_appearances./tv/tv_guest_personal_appearance/person	guest personal appearances. tv tv guest personal appearance person
/cvg/game_character/games./cvg/game_performance/game	games. cvg game performance game
/sports/pro_athlete/teams./baseball/baseball_roster_position/position	teams. baseball baseball roster position position
/olympics/olympic_medal/medal_winners./olympics/olympic_medal_honor/country	medal winners. olympics olympic medal honor country
/ice_hockey/hockey_player/former_team_s./sports/sports_team_roster/team	former team s. sports sports team roster team
/biology/breed_group/breeds_in_this_group./biology/breed_registration/breed	breeds in this group. biology breed registration breed
/tv/tv_program/tv_producer./tv/tv_producer_term/producer_type	tv producer. tv tv producer term producer type
/american_football/football_team/historical_roster./american_football/football_historical_roster_position/position_s	historical roster. american football football historical roster position position s
/organization/organization/board_members./organization/organization_board_membership/role	board members. organization organization board membership role
/education/educational_institution/students_graduates./education/education/major_field_of_study	students graduates. education education major field of study
/organization/organization/leadership./organization/leadership/role	leadership. organization leadership role
/basketball/basketball_player/team./basketball/basketball_roster_position/position	team. basketball basketball roster position position
/ice_hockey/hockey_team/historical_roster./ice_hockey/hockey_previous_roster_position/player	historical roster. ice hockey hockey previous roster position player
/sports/pro_athlete/teams./soccer/football_roster_position/position	teams. soccer football roster position position
/sports/sports_team/roster./baseball/baseball_roster_position/player	roster. baseball baseball roster position player
/business/business_operation/assets./measurement_unit/dated_money_value/currency	assets. measurement unit dated money value currency
/film/film/gross_revenue./measurement_unit/dated_money_value/currency	gross revenue. measurement unit dated money value currency
/education/field_of_study/students_majoring./education/education/student	students majoring. education education student
/tv/tv_producer_type/tv_producers_of_this_type./tv/tv_producer_term/producer	tv producers of this type. tv tv producer term producer
/tv/tv_program/tv_producer./tv/tv_producer_term/producer	tv producer. tv tv producer term producer
/education/university/international_tuition./measurement_unit/dated_money_value/currency	international tuition. measurement unit dated money value currency
/award/award_category/nominees./award/award_nomination/nominated_for	nominees. award award nomination nominated for
/military/military_combatant/military_commanders./military/military_command/military_commander	military commanders. military military command military commander
/location/statistical_region/gdp_nominal_per_capita./measurement_unit/dated_money_value/currency	gdp nominal per capita. measurement unit dated money value currency
/education/educational_institution/students_graduates./education/education/specialization	students graduates. education education specialization
/film/film_job/films_with_this_crew_job./film/film_crew_gig/film	films with this crew job. film film crew gig film
/tv/tv_series_season/regular_cast./tv/regular_tv_appearance/series	regular cast. tv regular tv appearance series
/film/film/other_crew./film/film_crew_gig/film_crew_role	other crew. film film crew gig film crew role
/education/educational_institution/students_graduates./education/education/minor	students graduates. education education minor
/film/film_distributor/films_distributed./film/film_film_distributor_relationship/film	films distributed. film film film distributor relationship film
/film/film_distribution_medium/films_distributed_in_this_medium./film/film_film_distributor_relationship/film	films distributed in this medium. film film film distributor relationship film
/business/board_member/organization_board_memberships./organization/organization_board_membership/role	organization board memberships. organization organization board membership role
/sports/sports_team/roster./ice_hockey/hockey_roster_position/player	roster. ice hockey hockey roster position player
/sports/sports_team/roster./american_football/football_historical_roster_position/player	roster. american football football historical roster position player
/sports/drafted_athlete/drafted./sports/sports_league_draft_pick/team	drafted. sports sports league draft pick team
/business/employer/employees./business/employment_tenure/person	employees. business employment tenure person
/basketball/basketball_player/team./sports/sports_team_roster/position	team. sports sports team roster position
/user/robert/military/military_person/participated_in_conflicts	robert military military person participated in conflicts
/government/governmental_jurisdiction/governing_officials./government/government_position_held/district_represented	governing officials. government government position held district represented
/tv/special_tv_performance_type/starring_performances./tv/regular_tv_appearance/character	starring performances. tv regular tv appearance character
/location/hud_foreclosure_area/total_90_day_vacant_residential_addresses./measurement_unit/dated_integer/source	total 90 day vacant residential addresses. measurement unit dated integer source
/soccer/football_player/current_team./soccer/football_roster_position/position	current team. soccer football roster position position
/government/governmental_jurisdiction/governing_officials./government/government_position_held/governmental_body	governing officials. government government position held governmental body
/government/government_office_or_title/office_holders./government/government_position_held/basic_title	office holders. government government position held basic title
/american_football/football_team/historical_coaching_staff./american_football/football_historical_coach_position/position	historical coaching staff. american football football historical coach position position
/tv/tv_series_episode/guest_stars./tv/tv_guest_role/actor	guest stars. tv tv guest role actor
/organization/role/governors./organization/organization_board_membership/organization	governors. organization organization board membership organization
/military/military_combatant/military_conflicts./military/military_combatant_group/combatants	military conflicts. military military combatant group combatants
/sports/sports_position/players./baseball/baseball_roster_position/player	players. baseball baseball roster position player
/soccer/football_player/current_team./soccer/football_roster_position/team	current team. soccer football roster position team
/film/film/personal_appearances./film/personal_film_appearance/type_of_appearance	personal appearances. film personal film appearance type of appearance
/government/governmental_jurisdiction/governing_officials./government/government_position_held/appointed_by	governing officials. government government position held appointed by
/tv/special_tv_performance_type/episode_performances./tv/tv_guest_role/actor	episode performances. tv tv guest role actor
/tv/special_tv_performance_type/starring_performances./tv/regular_tv_appearance/actor	starring performances. tv regular tv appearance actor
/government/politician/government_positions_held./government/government_position_held/district_represented	government positions held. government government position held district represented
/cvg/computer_videogame/characters./cvg/game_performance/character	characters. cvg game performance character
/people/appointed_role/appointment./people/appointment/appointee	appointment. people appointment appointee
/award/award_category/nominees./award/award_nomination/award_nominee	nominees. award award nomination award nominee
/film/actor/film./film/performance/special_performance_type	film. film performance special performance type
/film/personal_film_appearance_type/film_appearances./film/personal_film_appearance/film	film appearances. film personal film appearance film
/common/topic/webpage./common/webpage/topic	webpage. common webpage topic
/sports/pro_athlete/teams./ice_hockey/hockey_previous_roster_position/team	teams. ice hockey hockey previous roster position team
/location/statistical_region/population./measurement_unit/dated_integer/source	population. measurement unit dated integer source
/military/military_person/service./military/military_service/rank	service. military military service rank
/olympics/olympic_games/medals_awarded./olympics/olympic_medal_honor/country	medals awarded. olympics olympic medal honor country
/sports/sports_position/players./soccer/football_roster_position/player	players. soccer football roster position player
/government/government_office_category/officeholders./government/government_position_held/appointed_by	officeholders. government government position held appointed by
/location/hud_foreclosure_area/estimated_number_of_mortgages./measurement_unit/dated_integer/source	estimated number of mortgages. measurement unit dated integer source
/military/military_combatant/force_deployments./military/force_strength/combatant	force deployments. military force strength combatant
/baseball/baseball_player/former_teams./baseball/baseball_historical_roster_position/team	former teams. baseball baseball historical roster position team
/aviation/airport/airlines./aviation/airline_airport_presence/cities_served	airlines. aviation airline airport presence cities served
/military/military_conflict/force_strengths./military/force_strength/combatant	force strengths. military force strength combatant
/government/politician/government_positions_held./government/government_position_held/basic_title	government positions held. government government position held basic title
/sports/pro_athlete/teams./baseball/baseball_roster_position/team	teams. baseball baseball roster position team
/ice_hockey/hockey_player/current_team./ice_hockey/hockey_roster_position/position	current team. ice hockey hockey roster position position
/location/statistical_region/rent50_0./measurement_unit/dated_money_value/currency	rent50 0. measurement unit dated money value currency
/film/person_or_entity_appearing_in_film/films./film/personal_film_appearance/film	films. film personal film appearance film
/tv/non_character_role/tv_regular_personal_appearances./tv/tv_regular_personal_appearance/program	tv regular personal appearances. tv tv regular personal appearance program
/government/governmental_jurisdiction/governing_officials./government/government_position_held/basic_title	governing officials. government government position held basic title
/soccer/football_team/current_roster./soccer/football_roster_position/player	current roster. soccer football roster position player
/people/person/employment_history./business/employment_tenure/company	employment history. business employment tenure company
/sports/drafted_athlete/drafted./sports/sports_league_draft_pick/draft	drafted. sports sports league draft pick draft
/sports/sports_league_draft/picks./sports/sports_league_draft_pick/team	picks. sports sports league draft pick team
/government/politician/government_positions_held./government/government_position_held/legislative_sessions	government positions held. government government position held legislative sessions
/basketball/basketball_position/player_roster_position./basketball/basketball_roster_position/team	player roster position. basketball basketball roster position team
/government/government_office_or_title/office_holders./government/government_position_held/governmental_body	office holders. government government position held governmental body
/sports/professional_sports_team/draft_picks./sports/sports_league_draft_pick/draft	draft picks. sports sports league draft pick draft
/protected_sites/site_listing_category/listed_sites./protected_sites/natural_or_cultural_site_listing/listed_site	listed sites. protected sites natural or cultural site listing listed site
/sports/pro_athlete/teams./soccer/football_roster_position/team	teams. soccer football roster position team
/education/field_of_study/students_majoring./education/education/major_field_of_study	students majoring. education education major field of study
/exhibitions/exhibition_venue/exhibitions_at_this_venue./exhibitions/exhibition_run/sponsor	exhibitions at this venue. exhibitions exhibition run sponsor
/business/business_operation/revenue./measurement_unit/dated_money_value/currency	revenue. measurement unit dated money value currency
/education/field_of_study/students_majoring./education/education/institution	students majoring. education education institution
/olympics/olympic_athlete/medals_won./olympics/olympic_medal_honor/country	medals won. olympics olympic medal honor country
/business/business_operation/operating_income./measurement_unit/dated_money_value/currency	operating income. measurement unit dated money value currency
/sports/professional_sports_team/draft_picks./sports/sports_league_draft_pick/school	draft picks. sports sports league draft pick school
/film/special_film_performance_type/film_performance_type./film/performance/actor	film performance type. film performance actor
/sports/sports_team/roster./baseball/baseball_roster_position/position	roster. baseball baseball roster position position
/tv/tv_personality/tv_regular_appearances./tv/tv_regular_personal_appearance/appearance_type	tv regular appearances. tv tv regular personal appearance appearance type
/people/person/spouse_s./people/marriage/location_of_ceremony	spouse s. people marriage location of ceremony
/award/award_ceremony/awards_presented./award/award_honor/honored_for	awards presented. award award honor honored for
/government/political_appointer/appointees./government/government_position_held/office_position_or_title	appointees. government government position held office position or title
/sports/pro_athlete/teams./sports/sports_team_roster/team	teams. sports sports team roster team
/american_football/football_team/current_roster./american_football/football_roster_position/player	current roster. american football football roster position player
/sports/sports_team/roster./american_football/football_roster_position/position	roster. american football football roster position position
/government/governmental_jurisdiction/governing_officials./government/government_position_held/office_position_or_title	governing officials. government government position held office position or title
/american_football/football_coach_position/coaches_holding_this_position./american_football/football_historical_coach_position/coach	coaches holding this position. american football football historical coach position coach
/sports/sports_position/players./sports/sports_team_roster/team	players. sports sports team roster team
/government/government_office_category/officeholders./government/government_position_held/district_represented	officeholders. government government position held district represented
/tv/tv_actor/starring_roles./tv/regular_tv_appearance/series	starring roles. tv regular tv appearance series
/media_common/dedicated_work/dedication./media_common/dedication/dedicated_to	dedication. media common dedication dedicated to
/sports/sports_team/roster./baseball/baseball_historical_roster_position/player	roster. baseball baseball historical roster position player
/military/military_person/participated_in_conflicts	 military military person participated in conflicts
/film/film_character/portrayed_in_films./film/performance/actor	portrayed in films. film performance actor
/tv/special_tv_performance_type/starring_performances./tv/regular_tv_appearance/series	starring performances. tv regular tv appearance series
/transportation/road/end1./transportation/road_starting_point/location	end1. transportation road starting point location
/government/political_appointer/appointees./government/government_position_held/jurisdiction_of_office	appointees. government government position held jurisdiction of office
/sports/sports_award_type/winners./sports/sports_award/award_winner	winners. sports sports award award winner
/government/politician/government_positions_held./government/government_position_held/governmental_body	government positions held. government government position held governmental body
/tv/tv_producer/programs_produced./tv/tv_producer_term/producer_type	programs produced. tv tv producer term producer type
/travel/travel_destination/how_to_get_here./travel/transportation/transport_operator	how to get here. travel transportation transport operator
/ice_hockey/hockey_team/current_roster./ice_hockey/hockey_roster_position/player	current roster. ice hockey hockey roster position player
/government/political_appointer/appointees./government/government_position_held/office_holder	appointees. government government position held office holder
/film/personal_film_appearance_type/film_appearances./film/personal_film_appearance/person	film appearances. film personal film appearance person
/sports/sports_league_draft/picks./sports/sports_league_draft_pick/player	picks. sports sports league draft pick player
/music/performance_role/regular_performances./music/group_membership/role	regular performances. music group membership role
/government/government_office_or_title/office_holders./government/government_position_held/jurisdiction_of_office	office holders. government government position held jurisdiction of office
/military/armed_force/personnel./military/military_service/military_person	personnel. military military service military person
/location/statistical_region/gni_per_capita_in_ppp_dollars./measurement_unit/dated_money_value/currency	gni per capita in ppp dollars. measurement unit dated money value currency
/music/musical_group/member./music/group_membership/member	member. music group membership member
/sports/sports_team/roster./soccer/football_roster_position/player	roster. soccer football roster position player
/military/military_commander/military_commands./military/military_command/military_conflict	military commands. military military command military conflict
/media_common/dedicated_work/dedication./media_common/dedication/dedicated_by	dedication. media common dedication dedicated by
/sports/sports_team/roster./ice_hockey/hockey_previous_roster_position/player	roster. ice hockey hockey previous roster position player
/ice_hockey/hockey_team/current_roster./ice_hockey/hockey_roster_position/position	current roster. ice hockey hockey roster position position
/sports/pro_athlete/teams./basketball/basketball_historical_roster_position/team	teams. basketball basketball historical roster position team
/business/business_operation/current_assets./measurement_unit/dated_money_value/currency	current assets. measurement unit dated money value currency
/tv/non_character_role/tv_guest_personal_appearances./tv/tv_guest_personal_appearance/person	tv guest personal appearances. tv tv guest personal appearance person
/sports/sports_league_draft/picks./sports/sports_league_draft_pick/school	picks. sports sports league draft pick school
/tv/tv_program/regular_personal_appearances./tv/tv_regular_personal_appearance/appearance_type	regular personal appearances. tv tv regular personal appearance appearance type
/film/film_crewmember/films_crewed./film/film_crew_gig/film	films crewed. film film crew gig film
/military/military_conflict/combatants./military/military_combatant_group/combatants	combatants. military military combatant group combatants
/sports/pro_athlete/teams./american_football/football_roster_position/position	teams. american football football roster position position
/government/government_office_category/officeholders./government/government_position_held/office_holder	officeholders. government government position held office holder
/sports/professional_sports_team/draft_picks./sports/sports_league_draft_pick/player	draft picks. sports sports league draft pick player
/location/hud_foreclosure_area/estimated_number_foreclosures./measurement_unit/dated_integer/source	estimated number foreclosures. measurement unit dated integer source
/sports/pro_athlete/teams./basketball/basketball_roster_position/position	teams. basketball basketball roster position position
/film/film/estimated_budget./measurement_unit/dated_money_value/currency	estimated budget. measurement unit dated money value currency
/people/person/education./education/education/degree	education. education education degree
/organization/endowed_organization/endowment./measurement_unit/dated_money_value/currency	endowment. measurement unit dated money value currency
/olympics/olympic_athlete/country./olympics/olympic_athlete_affiliation/olympics	country. olympics olympic athlete affiliation olympics
/sports/sports_position/players./american_football/football_historical_roster_position/team	players. american football football historical roster position team
/travel/travel_destination/how_to_get_here./travel/transportation/transport_terminus	how to get here. travel transportation transport terminus
/location/hud_foreclosure_area/hhuniv./measurement_unit/dated_integer/source	hhuniv. measurement unit dated integer source
/sports/sports_position/players./american_football/football_historical_roster_position/player	players. american football football historical roster position player
/military/rank/used_by_services./military/military_service/military_force	used by services. military military service military force
/location/statistical_region/rent50_4./measurement_unit/dated_money_value/currency	rent50 4. measurement unit dated money value currency
/location/statistical_region/gni_in_ppp_dollars./measurement_unit/dated_money_value/currency	gni in ppp dollars. measurement unit dated money value currency
/business/board_member/leader_of./organization/leadership/role	leader of. organization leadership role
/american_football/football_coach/coaching_history./american_football/football_historical_coach_position/position	coaching history. american football football historical coach position position
/base/x2010fifaworldcupsouthafrica/world_cup_squad/current_world_cup_squad./base/x2010fifaworldcupsouthafrica/current_world_cup_squad/current_club	current world cup squad. base x2010fifaworldcupsouthafrica current world cup squad current club
/olympics/olympic_athlete/medals_won./olympics/olympic_medal_honor/medalist	olympic athlete medals won. olympics olympic medal honor medalist
/olympics/olympic_games/athletes./olympics/olympic_athlete_affiliation/sport	olympic games athletes. olympics olympic athlete affiliation sport
/olympics/olympic_sport/athletes./olympics/olympic_athlete_affiliation/olympics	olympic sport athletes. olympics olympic athlete affiliation olympics
/organization/organization/headquarters./location/mailing_address/citytown	organization headquarters. location mailing address citytown
/base/contractbridge/bridge_player/first_place_finish./base/contractbridge/bridge_tournament_standings/tournament	first place finish. base contractbridge bridge tournament standings tournament
/tv/tv_program/regular_cast./tv/regular_tv_appearance/seasons	tv program regular cast. tv regular tv appearance seasons
/government/legislative_session/members./government/government_position_held/basic_title	legislative session members. government government position held basic title
/base/nobelprizes/nobel_subject_area/nobel_awards./base/nobelprizes/nobel_honor/subject_area	nobel awards. base nobelprizes nobel honor subject area
/sports/sports_team/roster./basketball/basketball_roster_position/position	sports team roster. basketball basketball roster position position
/government/legislative_session/members./government/government_position_held/office_position_or_title	legislative session members. government government position held office position or title
/award/award_winning_work/awards_won./award/award_honor/award_winner	award winning work awards won. award award honor award winner
/award/award_nominated_work/award_nominations./award/award_nomination/award_nominee	award nominated work award nominations. award award nomination award nominee
/ice_hockey/hockey_team/historical_roster./sports/sports_team_roster/player	hockey team historical roster. sports sports team roster player
/base/localfood/food_producing_region/seasonal_availability./base/localfood/produce_availability/produce	seasonal availability. base localfood produce availability produce
/government/legislative_session/members./government/government_position_held/office_holder	legislative session members. government government position held office holder
/architecture/museum/address./location/mailing_address/citytown	museum address. location mailing address citytown
/travel/transport_terminus/travel_destinations_served./travel/transportation/mode_of_transportation	transport terminus travel destinations served. travel transportation mode of transportation
/award/award_winner/awards_won./award/award_honor/honored_for	award winner awards won. award award honor honored for
/award/award_nominee/award_nominations./award/award_nomination/award	award nominee award nominations. award award nomination award
/base/contractbridge/bridge_player/first_place_finish./base/contractbridge/bridge_tournament_standings/second_place	first place finish. base contractbridge bridge tournament standings second place
/olympics/olympic_participating_country/medals_won./olympics/olympic_medal_honor/olympics	olympic participating country medals won. olympics olympic medal honor olympics
/baseball/baseball_player/former_teams./sports/sports_team_roster/team	baseball player former teams. sports sports team roster team
/basketball/basketball_team/roster./sports/sports_team_roster/player	basketball team roster. sports sports team roster player
/baseball/baseball_player/current_team./sports/sports_team_roster/position	baseball player current team. sports sports team roster position
/award/hall_of_fame/inductees./award/hall_of_fame_induction/inductee	hall of fame inductees. award hall of fame induction inductee
/olympics/olympic_participating_country/athletes./olympics/olympic_athlete_affiliation/athlete	olympic participating country athletes. olympics olympic athlete affiliation athlete
/award/award_winner/awards_won./award/award_honor/award_winner	award winner awards won. award award honor award winner
/government/legislative_session/members./government/government_position_held/district_represented	legislative session members. government government position held district represented
/award/award_nominated_work/award_nominations./award/award_nomination/nominated_for	award nominated work award nominations. award award nomination nominated for
/base/contractbridge/bridge_player/second_place_finish./base/contractbridge/bridge_tournament_standings/second_place	second place finish. base contractbridge bridge tournament standings second place
/architecture/structure/address./location/mailing_address/state_province_region	structure address. location mailing address state province region
/olympics/olympic_games/athletes./olympics/olympic_athlete_affiliation/athlete	olympic games athletes. olympics olympic athlete affiliation athlete
/architecture/structure/address./location/mailing_address/citytown	structure address. location mailing address citytown
/ice_hockey/hockey_team/current_roster./sports/sports_team_roster/player	hockey team current roster. sports sports team roster player
/sports/sports_team/roster./sports/sports_team_roster/player	sports team roster. sports sports team roster player
/award/award_nominee/award_nominations./award/award_nomination/nominated_for	award nominee award nominations. award award nomination nominated for
/olympics/olympic_athlete/medals_won./olympics/olympic_medal_honor/olympics	olympic athlete medals won. olympics olympic medal honor olympics
/baseball/baseball_team/current_roster./sports/sports_team_roster/position	baseball team current roster. sports sports team roster position
/award/award_winner/awards_won./award/award_honor/ceremony	award winner awards won. award award honor ceremony
/base/localfood/produce/availability./base/localfood/produce_availability/seasonal_months	availability. base localfood produce availability seasonal months
/base/contractbridge/bridge_tournament/standing./base/contractbridge/bridge_tournament_standings/second_place	standing. base contractbridge bridge tournament standings second place
/travel/transport_terminus/travel_destinations_served./travel/transportation/travel_destination	transport terminus travel destinations served. travel transportation travel destination
/award/award_nominated_work/award_nominations./award/award_nomination/award	award nominated work award nominations. award award nomination award
/government/governmental_body/members./government/government_position_held/district_represented	governmental body members. government government position held district represented
/tv/tv_series_season/regular_cast./tv/regular_tv_appearance/seasons	tv series season regular cast. tv regular tv appearance seasons
/base/localfood/seasonal_month/produce_available./base/localfood/produce_availability/seasonal_months	produce available. base localfood produce availability seasonal months
/base/contractbridge/bridge_player/first_place_finish./base/contractbridge/bridge_tournament_standings/first_place	first place finish. base contractbridge bridge tournament standings first place
/government/governmental_body/members./government/government_position_held/jurisdiction_of_office	governmental body members. government government position held jurisdiction of office
/basketball/basketball_team/roster./basketball/basketball_roster_position/position	basketball team roster. basketball basketball roster position position
/base/fight/sentence/convictions./base/crime/criminal_conviction/convicted_person	convictions. base crime criminal conviction convicted person
/tv/tv_program/regular_cast./tv/regular_tv_appearance/actor	tv program regular cast. tv regular tv appearance actor
/ice_hockey/hockey_team/current_roster./sports/sports_team_roster/position	hockey team current roster. sports sports team roster position
/government/governmental_body/members./government/government_position_held/office_position_or_title	governmental body members. government government position held office position or title
/travel/transport_operator/travel_destinations_served./travel/transportation/mode_of_transportation	transport operator travel destinations served. travel transportation mode of transportation
/base/x2010fifaworldcupsouthafrica/world_cup_participant/world_cup_team./base/x2010fifaworldcupsouthafrica/current_world_cup_squad/current_club	world cup team. base x2010fifaworldcupsouthafrica current world cup squad current club
/organization/organization/headquarters./location/mailing_address/state_province_region	organization headquarters. location mailing address state province region
/film/actor/dubbing_performances./film/dubbing_performance/character	actor dubbing performances. film dubbing performance character
/architecture/museum/address./location/mailing_address/state_province_region	museum address. location mailing address state province region
/media_common/dedicator/dedications./media_common/dedication/work_dedicated	dedicator dedications. media common dedication work dedicated
/baseball/baseball_team/historical_roster./sports/sports_team_roster/player	baseball team historical roster. sports sports team roster player
/olympics/olympic_sport/athletes./olympics/olympic_athlete_affiliation/country	olympic sport athletes. olympics olympic athlete affiliation country
/award/hall_of_fame_induction_category/inductees./award/hall_of_fame_induction/inductee	hall of fame induction category inductees. award hall of fame induction inductee
/base/localfood/seasonal_month/produce_available./base/localfood/produce_availability/produce	produce available. base localfood produce availability produce
/film/actor/dubbing_performances./film/dubbing_performance/language	actor dubbing performances. film dubbing performance language
/basketball/basketball_team/roster./basketball/basketball_roster_position/player	basketball team roster. basketball basketball roster position player
/base/x2010fifaworldcupsouthafrica/world_cup_squad/current_world_cup_squad./base/x2010fifaworldcupsouthafrica/current_world_cup_squad/position	current world cup squad. base x2010fifaworldcupsouthafrica current world cup squad position
/basketball/basketball_team/roster./sports/sports_team_roster/position	basketball team roster. sports sports team roster position
/base/crime/convicted_criminal/convictions./base/crime/criminal_conviction/guilty_of	convictions. base crime criminal conviction guilty of
/american_football/football_player/former_teams./sports/sports_team_roster/team	football player former teams. sports sports team roster team
/base/contractbridge/bridge_player/second_place_finish./base/contractbridge/bridge_tournament_standings/first_place	second place finish. base contractbridge bridge tournament standings first place
/book/newspaper/headquarters./location/mailing_address/state_province_region	newspaper headquarters. location mailing address state province region
/book/newspaper/headquarters./location/mailing_address/citytown	newspaper headquarters. location mailing address citytown
/base/fight/crime_type/people_convicted_of_this_crime./base/crime/criminal_conviction/convicted_person	people convicted of this crime. base crime criminal conviction convicted person
/base/x2010fifaworldcupsouthafrica/world_cup_participant/world_cup_team./base/x2010fifaworldcupsouthafrica/current_world_cup_squad/position	world cup team. base x2010fifaworldcupsouthafrica current world cup squad position
/award/award_winning_work/awards_won./award/award_honor/award	award winning work awards won. award award honor award
/olympics/olympic_participating_country/medals_won./olympics/olympic_medal_honor/medal	olympic participating country medals won. olympics olympic medal honor medal
/olympics/olympic_participating_country/athletes./olympics/olympic_athlete_affiliation/sport	olympic participating country athletes. olympics olympic athlete affiliation sport
/ice_hockey/hockey_player/current_team./sports/sports_team_roster/position	hockey player current team. sports sports team roster position
/ice_hockey/hockey_player/current_team./sports/sports_team_roster/team	hockey player current team. sports sports team roster team
/baseball/baseball_player/current_team./sports/sports_team_roster/team	baseball player current team. sports sports team roster team
/base/fight/crime_type/people_convicted_of_this_crime./base/crime/criminal_conviction/guilty_of	people convicted of this crime. base crime criminal conviction guilty of
/award/award_winning_work/awards_won./award/award_honor/honored_for	award winning work awards won. award award honor honored for
/common/resource/annotations./common/webpage/topic	resource annotations. common webpage topic
/basketball/basketball_team/historical_roster./sports/sports_team_roster/player	basketball team historical roster. sports sports team roster player
/baseball/baseball_team/current_roster./sports/sports_team_roster/player	baseball team current roster. sports sports team roster player
/base/schemastaging/person_extra/net_worth./measurement_unit/dated_money_value/currency	person extra net worth. measurement unit dated money value currency
/media_common/dedicatee/dedications./media_common/dedication/work_dedicated	dedicatee dedications. media common dedication work dedicated
/olympics/olympic_participating_country/medals_won./olympics/olympic_medal_honor/medalist	olympic participating country medals won. olympics olympic medal honor medalist
/olympics/olympic_athlete/medals_won./olympics/olympic_medal_honor/medal	olympic athlete medals won. olympics olympic medal honor medal
/award/award_winner/awards_won./award/award_honor/award	award winner awards won. award award honor award
/tv/tv_series_season/regular_cast./tv/regular_tv_appearance/actor	tv series season regular cast. tv regular tv appearance actor
/base/contractbridge/bridge_tournament/standing./base/contractbridge/bridge_tournament_standings/first_place	standing. base contractbridge bridge tournament standings first place
/government/legislative_session/members./government/government_position_held/legislative_sessions	legislative session members. government government position held legislative sessions
/government/legislative_session/members./government/government_position_held/jurisdiction_of_office	legislative session members. government government position held jurisdiction of office
/award/award_winning_work/awards_won./award/award_honor/ceremony	award winning work awards won. award award honor ceremony
/award/award_nominee/award_nominations./award/award_nomination/award_nominee	award nominee award nominations. award award nomination award nominee
/base/contractbridge/bridge_player/second_place_finish./base/contractbridge/bridge_tournament_standings/tournament	second place finish. base contractbridge bridge tournament standings tournament
/government/governmental_body/members./government/government_position_held/legislative_sessions	governmental body members. government government position held legislative sessions
/common/annotation_category/annotations./common/webpage/topic	annotation category annotations. common webpage topic
/sports/sports_award_winner/awards./sports/sports_award/award	sports award winner awards. sports sports award award
/olympics/olympic_participating_country/athletes./olympics/olympic_athlete_affiliation/olympics	olympic participating country athletes. olympics olympic athlete affiliation olympics
/olympics/olympic_games/athletes./olympics/olympic_athlete_affiliation/country	olympic games athletes. olympics olympic athlete affiliation country
/travel/transport_operator/travel_destinations_served./travel/transportation/travel_destination	transport operator travel destinations served. travel transportation travel destination
/user/narphorium/people/wealthy_person/net_worth./measurement_unit/dated_money_value/currency	wealthy person net worth. measurement unit dated money value currency
/base/nobelprizes/nobel_prize_winner/nobel_honor./base/nobelprizes/nobel_honor/subject_area	nobel honor. base nobelprizes nobel honor subject area
/basketball/basketball_player/former_teams./sports/sports_team_roster/team	basketball player former teams. sports sports team roster team
/olympics/olympic_sport/athletes./olympics/olympic_athlete_affiliation/athlete	olympic sport athletes. olympics olympic athlete affiliation athlete
/sports/sports_team/roster./sports/sports_team_roster/position	sports team roster. sports sports team roster position
/government/governmental_body/members./government/government_position_held/basic_title	governmental body members. government government position held basic title
/sports/sports_team/roster./basketball/basketball_roster_position/player	sports team roster. basketball basketball roster position player
/film/film/dubbing_performances./film/dubbing_performance/language	film dubbing performances. film dubbing performance language
/sports/sports_league_season/awards./sports/sports_award/award	sports league season awards. sports sports award award
/soccer/football_player/current_team./sports/sports_team_roster/position	football player current team. sports sports team roster position
/film/film/dubbing_performances./film/dubbing_performance/character	film dubbing performances. film dubbing performance character
/government/governmental_body/members./government/government_position_held/office_holder	governmental body members. government government position held office holder
/american_football/football_team/historical_roster./sports/sports_team_roster/player	football team historical roster. sports sports team roster player
/base/schemastaging/tv_program_extra/regular_dubbing_performances./base/schemastaging/tv_star_dubbing_performance/actor	tv program extra regular dubbing performances. base schemastaging tv star dubbing performance actor
/american_football/football_team/current_roster./sports/sports_team_roster/position	american football football team current roster. sports sports team roster position
/soccer/football_team/current_roster./sports/sports_team_roster/player	soccer football team current roster. sports sports team roster player
/base/schemastaging/tv_character_extra/regular_dubbing_performances./base/schemastaging/tv_star_dubbing_performance/language	tv character extra regular dubbing performances. base schemastaging tv star dubbing performance language
/base/schemastaging/tv_actor_extra/regular_dubbing_performances./base/schemastaging/tv_star_dubbing_performance/program	tv actor extra regular dubbing performances. base schemastaging tv star dubbing performance program
/base/schemastaging/tv_program_extra/regular_dubbing_performances./base/schemastaging/tv_star_dubbing_performance/language	tv program extra regular dubbing performances. base schemastaging tv star dubbing performance language
/base/schemastaging/tv_character_extra/regular_dubbing_performances./base/schemastaging/tv_star_dubbing_performance/actor	tv character extra regular dubbing performances. base schemastaging tv star dubbing performance actor
/american_football/football_team/current_roster./sports/sports_team_roster/player	american football football team current roster. sports sports team roster player
/soccer/football_team/current_roster./sports/sports_team_roster/position	soccer football team current roster. sports sports team roster position
/american_football/football_player/current_team./sports/sports_team_roster/team	american football football player current team. sports sports team roster team
/base/schemastaging/tv_character_extra/regular_dubbing_performances./base/schemastaging/tv_star_dubbing_performance/program	tv character extra regular dubbing performances. base schemastaging tv star dubbing performance program
/base/schemastaging/tv_actor_extra/regular_dubbing_performances./base/schemastaging/tv_star_dubbing_performance/language	tv actor extra regular dubbing performances. base schemastaging tv star dubbing performance language
/base/schemastaging/tv_program_extra/regular_dubbing_performances./base/schemastaging/tv_star_dubbing_performance/character	tv program extra regular dubbing performances. base schemastaging tv star dubbing performance character
/base/schemastaging/tv_actor_extra/regular_dubbing_performances./base/schemastaging/tv_star_dubbing_performance/character	tv actor extra regular dubbing performances. base schemastaging tv star dubbing performance character
/soccer/football_player/current_team./sports/sports_team_roster/team	soccer football player current team. sports sports team roster team
